SHAWN MATEY|"A Midsummer night's dream"|Benjamin Britten|James Conlon|Lysander, innamorato di Hermia|Opera di Roma|Paul Curran
TAMARA GURA|"A Midsummer night's dream"|Benjamin Britten|Hermia, innamorata di Lysander|James Conlon|Opera di Roma|Paul Curran
PETER STRUMMER|"A Midsummer night's dream"|Benjamin Britten|James Conlon|Opera di Roma|Paul Curran|Peter Quince, falegname
PHILLIP ADDIS|"A Midsummer night's dream"|"Billy Budd"|Andrea Battistoni|Benjamin Britten|Billy Budd|Davide Livermore|Demetrius, innamorato di Hermia|Genova, Teatro Carlo Felice|James Conlon|Opera di Roma|Paul Curran
VALDIMIR VANEEV|"Lady Macbeth del distretto di Mzesnk"|Dimitrij Sostakovic|Fantasma di Boris|Firenze, Teatro Comunale|James Conlon|Lev Dodin
ALESSANDRO CALAMAI|"Boris Godunov"|"Die Zauberflöte" (Il flauto magico)|"La Bohème"|"La rondine"|"La traviata"|"Lady Macbeth del distretto di Mzesnk"|"Macbeth"|"Madama Butterfly"|"Turandot"|Alcidoro|Brescia, Teatro Grande|Carlomoreno Volpini|Crébillon|Dimitrij Sostakovic|Elio Boncompagni|Eugenio Monti Colla|Fabio Ceresa|Firenze, Teatro Comunale|Firenze, Teatro della Pergola|George Pehlivanian|Giacomo Puccini|Giampaolo Bisanti|Gino Zampieri|Giuseppe Verdi|Graham Vick|Hugo De Ana|Il Barone Douphol|Il principe Yamadori|James Conlon|Lavickij|Lev Dodin|Lucca, Teatro del Giglio|Mandarino|Marcello Mottadelli|Marco Gandini|Massimiliano Stefanelli|Modena, Teatro Comunale|Modest Musorgskij|Oliver Gooch|Opera di Firenze|Palermo, Teatro di Verdura|Renato Bonajuto|Secondo Armigero/Primo Sacerdote|Sentinella|Teatro Goldoni di Livorno|Teatro Massimo di Palermo|Un domestico|Willy Landin|Wolfgang Amadeus Mozart
ANDREA CORTESE|"La Bohème"|"La Traviata"|"Lady Macbeth del distretto di Mzesnk"|Andrea Battistoni|Arena di Verona|Benoît|Carlo Montanaro|Dimitrij Sostakovic|Domestico/Commissionario|Firenze, Teatro Comunale|Giacomo Puccini|Giuseppe Verdi|Hugo De Ana|James Conlon|L'amministratore|Lavoratore del Mulino|Lev Dodin|Mario Pontiggia|Teatro Comunale di Firenze|Terzo bracciante|Verona «o cara, noi rivedremo»'...ancora “Traviata”|’Arena
ANDREA SNARSKY|"Lady Macbeth del distretto di Mzesnk"|Dimitrij Sostakovic|Firenze, Teatro Comunale|James Conlon|Lev Dodin|Un poliziotto
ARMANDO CAFORIO|"La Traviata"|"Lady Macbeth del distretto di Mzesnk"|"Tosca"|Arena di Verona|Carlo Rizzi|Dimitrij Sostakovic|Firenze, Teatro Comunale|Giacomo Puccini|Giuseppe Verdi|Henning Brockhaus|Hugo De Ana|James Conlon|Lev Dodin|Marchese d'Obigny|Marco Armiliato,Marco Tonini|Palermo, Teatro Massimo|Sergente|Un Carceriere
ELENA BORIN|"Carmen"|"Il Trovatore"|"L'elisir d'amore"|"Lady Macbeth del distretto di Mzesnk"|"Macbeth"|"Madama Butterfly"|"Nabucco"|"Rigoletto"|-|Anna|Arena di Verona|Arena di Verona 2008|Berta|Bologna, Teatro Comunale|Dama della Lady|Damiano Michieletto|Daniele Abbado|Dimitrij Sostakovic|Firenze, Teatro Comunale|Firenze, Teatro della Pergola|Francesco Micheli|Franco Zeffirelli|Frasquita|Gaetano Donizetti|Georges Bizet|Giacomo Puccini|Giannetta|Gioachino Rossini|Giuliano Carella|Giuseppe Verdi|Graham Vick|Il ritorno del "Barbiere di Siviglia"|Ines|Ivo Guerra|James Conlon|La Cugina|Lev Dodin|Lorenzo Fratini,Giuseppe La Malfa|Luciano Acocella|Marco Armiliato|Michał Znaniecki|Nicola Luisotti|Paggio della duchessa|Paolo Facincani,Julian Kovatchev|Parma, Teatro Regio|Paul Curran|Renato Palumbo|Riccardo Canessa|Rosetta Cucchi|Stefano Montanari|Stefano Ranzani|Teatro Filarmonico di Verona|Teatro Massimo di Palermo|Teatro San Carlo di Napoli|Teatro del Maggio Musicale Fiorentino|Una forzata|Verona, Arena Opera Festival
FABIO BERTELLA|"Lady Macbeth del distretto di Mzesnk"|Dimitrij Sostakovic|Firenze, Teatro Comunale|James Conlon|Lev Dodin|Secondo bracciante
GORDON GIETZ|"A midsummer night's dream"|-|Benjamin Britten|Daniele Abbado|Jonathan Webb|Lysander|Male Chorus|Reggio Emilia, Teatro Valli|Robert Carsen|Sir Andrew Davis|Teatro alla Scala|“The Rape of Lucretia”
GREAME DANBY|"A midsummer night's dream"|-|Robert Carsen|Sir Andrew Davis|Snug|Teatro alla Scala
ROBERTO FRONTALI|"Attila"|"Il Trittico" di Giacomo Puccini|"Il Trovatore"|"La Traviata"|"Nabucco"|"Otello"|"Rigoletto"|"Stiffelio"|"Tosca"|-|A Firenze una "Forza del destino"|Andrea Battistoni|Arena di Verona|Bologna, Teatro Comunale|Damiano Michieletto|Daniele Abbado|Daniele Callegari|Daniele Rustioni|Diego Matheuz|Don Carlo di Vargas|Donato Renzetti|Ezio, generale romano|Georges Lavaudant|Giacomo Puccini|Gianandrea Noseda|Gianni Schicchi|Giorgio Germont|Giulio Ciabatti|Giuseppe Verdi|Guy Montavon|Hugo De Ana|Il "Trittico" secondo Michieletto|Il Barone Scarpia|Il Conte di Luna|Il barone Scarpia|Il conte di Luna|Jader Bignamini|Jago|Michele|Nabucco|Nicolas Joël|Palermo, Teatro Massimo|Parma, Teatro Regio|Paul Curran|Rani Calderon|Reggio Emilia, Teatro Valli|Renato Palumbo|Rigoletto|Roma, Teatro dell'Opera|Serena Sinigaglia|Sofia Coppola|Stankar|Teatro La Fenice|Teatro Regio di Parma|Teatro Regio di Torino|Theater an der Wien|Trieste, Teatro Verdi|Verona, Teatro Filarmonico|Walter Sutcliffe|’insegna del patriottismo
NICOLO' DE MAESTRI|"A midsummer night's dream"|-|Moth|Robert Carsen|Sir Andrew Davis|Teatro alla Scala
DEANNE MEEK|"A midsummer night's dream"|-|Hermia|Robert Carsen|Sir Andrew Davis|Teatro alla Scala
ELENA CACCAMO|"A midsummer night's dream"|"Le nozze di Figaro"|"Tannhäuser"|-|Carlus Padrissa – La Fura Dels Baus|Due contadine|Hirt|Mario Martone|OperaLombardia,  Teatro Sociale di Como|Peaseblossom|Robert Carsen|Sir Andrew Davis|Stefano Montanari|Teatro Fraschini di Pavia|Teatro alla Scala|Wolfgang Amadeus Mozart|Zubin Mehta
ERIN WALL|"A midsummer night's dream"|-|Helena|Robert Carsen|Sir Andrew Davis|Teatro alla Scala
FRANCESCA MERCURIALI|"A midsummer night's dream"|-|Cobweb|Robert Carsen|Sir Andrew Davis|Teatro alla Scala
ROSEMARY JOSHUA|"A midsummer night's dream"|-|Robert Carsen|Sir Andrew Davis|Teatro alla Scala|Tytania
SIMON BUTTERISS|"A midsummer night's dream"|-|Robert Carsen|Robin Starveling|Sir Andrew Davis|Teatro alla Scala
ANNA MALAVASI|"Falstaff"|"Il Trittico" di Giacomo Puccini|"Il Trovatore"|"L'Enfant Prodigue" e "Cavalleria Rusticana"|"La Traviata"|"Macbeth"|"Madama Butterfly"|"Nabucco"|"Nabucodonosor"|"Ola" per Rigoletto|"Otello"|"Rigoletto"|"Zaira"|-|Ancona, Teatro delle Muse|Arena di Verona|Arnaud Bernard|Azucena|Carla Delfrate|Cristina Mazzavillani Muti|Dama di Lady Macbeth|Damiano Michieletto|Daniele Abbado|Daniele Rustioni|Diego Matheuz|E Cristina disse|Emilia|Fenena|Flora Bervoix|Giacomo Puccini|Giacomo Sagripanti|Gianfranco De Bosio|Giorgio Ferrara|Giuseppe Verdi|Henning Brockhaus|Ivo Guerra|Jader Bignamini|Jean-paul Scarpitta|Julian Kovatchev|La Badessa|La Ciesca|La Frugola|Maddalena|Mrs. Meg Page|Nerestano|Nicola Paszkowski|Opera di Firenze|Palermo|Parma, Teatro Regio|Peter Stein|Pietro Mascagni,Claude Debussy|Pinchas Steinberg|Ravenna, Teatro Alighieri|Reggio Emilia, Teatro Valli|Renato Palumbo|Riccardo Frizza|Riccardo Muti|Roma, Teatro dell'Opera|Roma,Teatro dell'Opera|Rosetta Cucchi|Santuzza|Sofia Coppola|Suzuki|Teatro delle Muse di Ancona|Venezia, Teatro La Fenice|Vincenzo Bellini|XXXVIII° Festival della Valle d'Itria|Zubin Mehta|“ Facciamo Trovatore… ”
PETER SAVIDGE|"A Midsummer night's dream"|Benjamin Britten|James Conlon|Opera di Roma|Paul Curran|Theseus, Duca di Atene
MICHAEL BATTEN|"A Midsummer night's dream"|Benjamin Britten|James Conlon|Opera di Roma|Paul Curran|Puck
GEORGE HUMPHREYS|"A Midsummer night's dream"|Benjamin Britten|James Conlon|Opera di Roma|Paul Curran|Robin Straveling, sarto
CLAUDIA BOYLE|"A Midsummer night's dream"|Benjamin Britten|James Conlon|Opera di Roma|Paul Curran|Tytania, Regina delle Fate
MARTA PACIFICI*|"A Midsummer night's dream"|Benjamin Britten|Cobweb, folletto|James Conlon|Opera di Roma|Paul Curran
LAWRENCE ZAZZO|"A Midsummer night's dream"|-|Arsace|Benjamin Britten|James Conlon|Maxim Emelyanychev|Oberon, Re delle Fate|Opera di Roma|Paul Curran|’Auditorio Nacional di Madrid|“Partenope” di Händel
CAMILLA MALPICCI*|"A Midsummer night's dream"|Benjamin Britten|James Conlon|Moth, folletto,|Opera di Roma|Paul Curran
ANTONY DEAN GRIFFEY|"A Midsummer night's dream"|Benjamin Britten|Francis Flute, acconciamantici|James Conlon|Opera di Roma|Paul Curran
MARISOL MONTALVO|"Penthesilea"|Franck Ollu|Pascal Dusapin|Pierre Audi|Prothoe|Théâtre La Monnaie
MARTA BERETTA|"Penthesilea"|Amazone|Franck Ollu|Pascal Dusapin|Pierre Audi|Théâtre La Monnaie
WIARD WITHOLT|"Penthesilea"|Bote|Franck Ollu|Pascal Dusapin|Pierre Audi|Théâtre La Monnaie
YAROSLAVA KOZINA|"Penthesilea"|Botin|Franck Ollu|Pascal Dusapin|Pierre Audi|Théâtre La Monnaie
MATTEO PEIRONE|"Il Trittico" di Giacomo Puccini|"La Bohème"|"Le nozze di Figaro"|"Tosca"|-|Alcindoro|Andrea Battistoni|Antonio|Benoit|Benoît /Alcindoro|Benoît e Alcindoro|Damiano Michieletto|Daniele Rustioni|Davide Livermore|Dmitri Jurowski|Elena Barbalich|Franco Zeffirelli|Genova, Teatro Carlo Felice|Giacomo Puccini|Gianandrea Noseda|Giuseppe Patroni Griffi|Gustavo Dudamel|Il sagrestano|Jean-louis Grinda|La bohème|Lamberto Puggelli|Lorenzo Amato|Maestro Spinelloccio|Massimo Zanetti|Milano, Teatro alla Scala|Pietro Fléville|Renato Palumbo|Roma, Teatro dell'Opera|Sagrestano|Saverio Santoliquido,Renato Palumbo|Teatro Regio di Torino|Torino, Teatro Regio|Umberto Giordano|Vittorio Borrelli|Wolfgang Amadeus Mozart|Yutaka Sado|«Il nostro è amore d’anime!» Andrea Chénier
CRISTIANO OLIVIERI|"Der König Kandaules"|"Die Zauberflöte"|"Falstaff"|"Fedora"|"I Vespri Siciliani"|"Il Campiello"|"Il Trovatore"|"Lady Macbeth del distretto di Mzesnk"|"Lucia di Lammermoor"|"Otello"|"Stiffelio"|"The Greek Passion"|"Tosca"|"Turandot"|-|Abdallo|Alexander Zemlinsky|Ancora “Nabucco”|Andrea Battistoni|Arena di Verona|Arminio|Asher Fisch|Bologna, Teatro Comunale|Bruno Campanella|Camille Saint-saëns|Cassio|Comunale di Bologna|Damiano Michieletto|Daniele Callegari|Daniele Rustioni|Davide Livermore|Desiré, cameriere|Dimitrij Sostakovic|Dona Cate Panciana|Dottor Cajus|Eliahu Inbal|Enrico Stinchelli|Ermanno Wolf-ferrari|Erster geharnischter Mann (Primo uomo armato)|Federico di Frengel|Firenze, Teatro Comunale|Francesco Cilluffo|Franco Zeffirelli|Gabriele Ferro|Gabriele Lavia|Gaetano Donizetti|Giacomo Puccini|Gianandrea Noseda|Gianfranco De Bosio|Gianni Marras|Giuliano Carella|Giuseppe|Giuseppe Verdi|Graham Vick|Hugo De Ana|Il principe di Persia|Jader Bignamini|James Conlon|Johannes Weigand|Julian Kovatchev|Lamberto Puggelli|Leo Muscato|Lev Dodin|Luca Ronconi|Luigi De Angelis|Manfred Schweigkofler|Maurizio Agostini|Messaggero|Michal Znaniecki|Michele Mariotti|Napoli, Teatro di San Carlo|Normanno|Palermo, Teatro Massimo|Panait|Paolo Facincani,Andrea Battistoni,Armando Tasso|Pinchas Steinberg|Pisa, Teatro Verdi|Roberto Andò|Samson et Dalila|Secondo sacerdote/Primo armigero|Serena Sinigaglia|Spoletta|Syphax|Teatro La Fenice|Teatro Massimo di Palermo|Teatro San Carlo di Napoli|Teatro Valli di Reggio Emilia|Teatro dell'Opera di Firenze|Teatro la Fenice di Venezia|Tebaldo|Torino, Teatro Regio|Umberto Giordano|Un maestro|Un messo|Verona «o cara, noi rivedremo»'...ancora “Traviata”|Wolfgang Amadeus Mozart|Zweiter Priester (Secondo sacerdote)|’Arena|’Arena di Verona
ROBERT HOLZER|"Fidelio"|"Salome"|Don Fernando|Gabriele Ferro|Gianandrea Noseda|Ludwig Van Beethoven|Manfred Schweigkofler|Mario Martone|Richard Strauss|Teatro San Carlo di Napoli|Torino, Teatro Regio|Zwei Nazarener
NICOLÒ CERIANI|"Carmen"|"Der König Kandaules"|"Evgenij Onegin"|"Il cappello di paglia di Firenze"|"La Traviata"|"La vedova allegra"|"Madama Butterfly"|"Rigoletto"|"Roméo et Juliette"|"Roméo et Juliette" di Gounod|"Salome"|"Turandot"|"Un ballo in maschera"|-|Alexander Zemlinsky|Andrea Battistoni|Andrea Cigni|Arena di Verona|Armando Tasso,Marko Letonja,Maria Grazia Garofoli|Asher Fisch|Aziz Shokhakimov|Barona Duphol|Barone Douphol|Bologna, Teatro Comunale|Carlo Montanaro|Charles Gounod|Christoph Campestrini|Damiano Michieletto|Emilio|Fabio Mastrangelo|Firenze|Francesco Micheli|Franco Zeffirelli|Franz Lehár|Frédéric Chaslin|Gabriele Ferro|Georges Bizet|Giacomo Puccini|Giuseppe Finzi|Giuseppe Verdi|Henning Brockhaus|Hirofumi Yoshida|Hugo De Ana|Il Commissario Imperiale|Il Conte di Ceprano|Il barone Mirko Zeta|Il conte di Ceprano|Il conte di Monterone|Jean-luc Tingaud|Lo zio Bonzo|Manfred Schweigkofler|Marco Armiliato|Marco Boemi|Mariusz Treliński|Massimo Gasparon|Moralès|Nino Rota|Opera di Firenze|Palermo, Teatro Massimo|Paolo Arrivabeni|Paolo Facincani,Andrea Battistoni,Armando Tasso|Paris|Phedros|Pietro Babina|Pâris|Pëtr Il’ič Čajkovskij|Richard Strauss|Roberto De Simone|Silvano|Teatro Massimo di Palermo|Teatro Regio di Torino|Teatro San Carlo di Napoli|Un Mandarino|Un capitano della guardia|Un mandarino|Valentina Brunetti|Verona, Arena Opera Festival|Verona, Teatro Filarmonico|Zubin Mehta|Zwei Nazarener
MARIANNA ORTIZ|-|Frasquita|Georges Bizet|Gustavo Dudamel|Gustavo Dudamel dirige "Carmen"|Los Angeles
YONGHOON LEE|"Pagliacci/Cavalleria rusticana"|"Turandot"|-|Bologna, Teatro Comunale|Calaf|Daniel Harding|Don José|Fabio Mastrangelo|Georges Bizet|Giacomo Puccini|Gustavo Dudamel|Gustavo Dudamel dirige "Carmen"|Los Angeles|Mario Martone|Milano, Teatro alla Scala|Pietro Mascagni|Roberto De Simone|Turiddu
FRANCOIS LIS|"La forza del destino"|-|Georges Bizet|Giuseppe Verdi|Gustavo Dudamel|Gustavo Dudamel dirige "Carmen"|Jean-claude Auvray|Los Angeles|Parigi, Opéra|Un chirurgo|Zúñiga
HAK SOO KIM|-|Georges Bizet|Gustavo Dudamel|Gustavo Dudamel dirige "Carmen"|Los Angeles|Remendado
JENNIFER HOLLOWAY|"La Traviata"|-|Flora Bervoix|Georges Bizet|Gianandrea Noseda|Giuseppe Verdi|Gustavo Dudamel|Gustavo Dudamel dirige "Carmen"|Los Angeles|Mercédès|New York, Metropolitan Opera|Willy Decker
KYLE KETELSEN|"Don Giovanni"|"Le nozze di Figaro"|-|Alejo Pérez|Dmitri Tcherniakov|Escamillo|Festival di Aix-en-Provence|Figaro|Georges Bizet|Gustavo Dudamel|Gustavo Dudamel dirige "Carmen"|Jérémie Rhorer|Leporello|Los Angeles|Madrid, Teatro Real|Wolfgang Amadeus Mozart
EVE-MAUD HUBEAUX|"Béatrice et Bénédict"|"L'enfant et les sortilèges"|"Penthesilea"|-|Arnaud Meunier|Bruxelles, Théâtre La Monnaie|Didier Puntos|Festival di Aix-en-Provence|Franck Ollu|Maman, la Tasse Chinoise, la Libellule|Maurice Ravel|Oberpriesterin|Pascal Dusapin|Pierre Audi|Richard Brunel|Samuel Jean|Théâtre La Monnaie|Ursula
ALEXIA VOULGARIDOU|"Carmen"|"La Bohème"|"Tosca"|-|Donato Renzetti|Elisabetta Brusa|Emma Dante|Floria Tosca|Georges Bizet|Giacomo Puccini|Giulio Ciabatti|Gustavo Dudamel|Gustavo Dudamel dirige "Carmen"|Los Angeles|Micaela|Micaëla|Mimì|Teatro alla Scala|Trieste|Trieste, Teatro Verdi
VALDIS JANSONS|"Carmen"|"Die Zauberflöte"|"Il campanello" e "Gianni Schicchi"|"L'Amico Fritz"|"La Traviata"|"Lulu"|"Tannhäuser"|"Turandot"|-|Andrea Battistoni|Andrea Cigni|Antonio Pirolli|Barone|Benjamin Bayl|Biterolf|Bologna, Teatro Comunale|Daniele Abbado|Daniele Gatti|David|Escamillo|Fabio Luisi|Genova, Teatro Carlo Felice|Georges Bizet|Giacomo Puccini|Giacomo Puccini,Gaetano Donizetti|Giuseppe Verdi|Guy Montavon|Il marchese d’Obigny|Jean-louis Grinda|Johannes Wildner|Mandarino|Marco|Modena, Teatro Comunale|Peter Stein|Pietro Mascagni|Pietro Rizzo|Rolando Panerai|Rosetta Cucchi|Sprecher und Erster Priester|Stefan Anton Reck|Teatro Carlo Felice di Genova|Teatro Comunale di Sassari|Teatro Filarmonico di Verona|Teatro alla Scala|Un giornalista|Valerio Galli|Wolfgang Amadeus Mozart
DANIELE MASSIMI|"Il Barbiere di Siviglia"|"Il Trittico" di Giacomo Puccini|"La Traviata"|Damiano Michieletto|Daniele Rustioni|Domestico di Flora|Giacomo Puccini|Gioachino Rossini|Giuseppe Verdi|Guccio|Jader Bignamini|Lorenzo Mariani|Roma, Teatro dell'Opera|Roma, Terme di Caracalla|Sofia Coppola|Stefano Montanari|Un Ufficiale
ROMINA TOMASONI|"Die Zauberflote"|"Il cappello di paglia di Firenze"|"La voix humaine" e "Suor Angelica"|"Le braci"|"Lulu"|"Nabucco"|"Orfeo all'inferno"|-|Andrea Battistoni|Andrea Cigni|Andrea De Rosa|Antonello Allemandi|Daniele Gatti|David Mc Vicar|Erik Nielsen|Fenena, figlia di Nabucco|Firenze|Firenze, Palazzo Pitti|Firenze, Teatro Comunale|Francesco|Giacomo Puccini,Francis Poulenc|Giuseppe Verdi|Jacques Offenbach|La Badessa|La Baronessa di Champigny|La baronessa di Champigny|Leo Muscato|Marco Carniti|Nini|Nino Rota|Opera di Firenze|Opera di Roma|Opinione pubblica|Padova, Teatro Verdi|Peter Stein|Sergio Alapont|Stefano Poda|Sua madre|Teatro alla Scala|Wolfgang Amadeus Mozart|Xu Zhong|Zweite Dame
RUDOLF ROSEN|"Lulu"|-|Daniele Gatti|Peter Stein|Teatro alla Scala|Un domatore/un atleta
LAURA AIKIN|"Lulu"|-|Alban Berg|Alvis Hermanis|Bernd Alois Zimmermann|Daniele Gatti|Ingo Metzmacher|Lulu|Marie|Michael Schonwandt|Parigi, Opéra Bastille|Peter Stein|Teatro alla Scala|Willy Decker|“Die Soldaten” al Teatro alla Scala
MAGDALENA ANNA HOFFMANN|"Lulu"|-|Daniele Gatti|Peter Stein|Teatro alla Scala|Uno studente/Gromm
FRANZ MAZURA|"Elektra"|"Lulu"|-|Daniele Gatti|Der Pfleger des Orest|Patrice Ch|Peter Stein|Richard Strauss|Schigolch/un clown|Teatro alla Scala|Teatro alla Scala di Milano
GIOVANNI LUCINI|"Lulu"|-|Commissario di polizia|Daniele Gatti|Peter Stein|Teatro alla Scala
BERTRAM KLAMP|"Lulu"|-|Daniele Gatti|Peter Stein|Teatro alla Scala|Un domestico
CLAUDIA BANDERA|"Lulu"|-|Daniele Gatti|Peter Stein|Teatro alla Scala|Un’arredatrice
STEFAN VINKE|" Götterdämmerung"|"Götterdämmerung"|-|Charles Tim Buck,Asher Fisch|Jeffrey Tate|Marc Soustrot|Peter Konwitschny|Robert Carsen|Seattle|Siegfried|Staatsoper Stuttgart|Stephen Wadsworth|Venezia, Teatro La Fenice|un "Ring" che avrebbe reso Wagner orgoglioso
NICOLA BELLER CARBONE|"Der König Kandaules"|"Götterdämmerung"|-|Alexander Zemlinsky|Asher Fisch|Gutrune|Jeffrey Tate|Manfred Schweigkofler|Nyssia|Robert Carsen|Teatro Massimo di Palermo|Venezia, Teatro La Fenice
JAYNE CASSELMAN|"Götterdämmerung"|-|Brunnhilde|Jeffrey Tate|Robert Carsen|Venezia, Teatro La Fenice
GIDON SAKS|"Götterdämmerung"|-|Hagen|Jeffrey Tate|Robert Carsen|Venezia, Teatro La Fenice
PETER ROSE|"A Midsummer night's dream"|"Capriccio"|"Der Rosenkavalier"|"Tristan und Isolde"|-|Andrew Davis|Benjamin Britten|Der Baron Ochs|Herbert Wernicke,Alejandro Stadler|James Conlon|John Cox|La Roche|Metropolitan Opera|Mikko Franck|Milano, Teatro alla Scala|Nick Bottom, tessitore|Opera di Roma|Parigi, Salle Pleyel|Paul Curran|Philippe Jordan|Re Marke|Richard Strauss
THOMAS PIFFKA|"Lulu"|-|Alwa|Daniele Gatti|Peter Stein|Teatro alla Scala
CHIARA PIERETTI|"Il Naso"|"Il Trittico" di Giacomo Puccini|"La Traviata"|"La rondine"|Alejo Perez|Annina|Damiano Michieletto|Daniele Rustioni|Dmitrij Šostakovič|Giacomo Puccini|Gino Zampieri|Giuseppe Verdi|Jader Bignamini|La venditrice di ciambelle|Lisette|Massimiliano Stefanelli|Modena, Teatro Comunale|Opera di Roma|Peter Stein|Roma, Teatro dell'Opera|Sofia Coppola|Suor Dolcina/ prima conversa
STEPHEN WEST|"Lulu"|-|Daniele Gatti|Dottor Schon/Jack|Peter Stein|Teatro alla Scala
STEFANIE IRANYI|"Die Walküre"|"Götterdämmerung"|"Věc Makropulos"|-|Firenze|Firenze, Teatro Comunale|Jeffrey Tate|La Fura Dels Baus (carlus Padrissa)|Robert Carsen|Rossweisse|Un’inserviente|Venezia, Teatro La Fenice|Wellgunde|William Friedkin|Zubin Mehta
BEATRICE MEZZANOTTE|"Il Trittico" di Giacomo Puccini|"Pimpinone"|Damiano Michieletto|Daniele Rustioni|Giacomo Puccini|Gianni Gualdoni|Nicola Procaccini|Roma, Teatro dell'Opera|Suor Osmina/la novizia|Tomaso Albinoni|Vespetta|galleria Pianetti di Jesi
VALDIMIR MATORIN|"Lady Macbeth del distretto di Mzesnk"|Capo della polizia|Dimitrij Sostakovic|Firenze, Teatro Comunale|James Conlon|Lev Dodin
SERGEJ KUNAEV|"Lady Macbeth del distretto di Mzesnk"|Dimitrij Sostakovic|Firenze, Teatro Comunale|James Conlon|Lev Dodin|Sergej
MARCO DE CAROLIS|"Lady Macbeth del distretto di Mzesnk"|Dimitrij Sostakovic|Firenze, Teatro Comunale|James Conlon|Lev Dodin|Primo bracciante
LEONID BOMSTEIN|"Il Naso"|"Lady Macbeth del distretto di Mzesnk"|Alejo Perez|Dimitrij Sostakovic|Dmitrij Šostakovič|Firenze, Teatro Comunale|Il Naso|James Conlon|Lev Dodin|Opera di Roma|Peter Stein|Un balordo
JULIAN RODESCU|"Lady Macbeth del distretto di Mzesnk"|Dimitrij Sostakovic|Firenze, Teatro Comunale|James Conlon|Lev Dodin|Un pope
JEANNE-MICHÈLE CHARBONNET|"Elektra"|"Lady Macbeth del distretto di Mzesnk"|-|Charles Roubaud|Dimitrij Sostakovic|Elektra|Firenze, Teatro Comunale|James Conlon|Katerina Izmajlova|Lev Dodin|Opéra di Marsiglia|Richard Strauss
PIERGIORGIO CHIVAZZA|"Lady Macbeth del distretto di Mzesnk"|Dimitrij Sostakovic|Firenze, Teatro Comunale|James Conlon|Lev Dodin|Ospite ubriaco
NIKOLAJ BIKOV|"Lady Macbeth del distretto di Mzesnk"|Dimitrij Sostakovic|Firenze, Teatro Comunale|Il portiere|James Conlon|Lev Dodin
NATASCHA PETRINSKY|"A Midsummer night's dream"|"A midsummer night's dream"|"Götterdämmerung"|"Il Trittico" di Giacomo Puccini|"Lady Macbeth del distretto di Mzesnk"|"Lulu"|"Penthesilea"|"Salome"|-|Benjamin Britten|Carmen|Contessa Geschwitz/ Una guardarobiera del teatro|Damiano Michieletto|Daniele Gatti|Daniele Rustioni|Dimitrij Sostakovic|Firenze, Teatro Comunale|Franck Ollu|Gabriele Ferro|Georges Bizet|Giacomo Puccini|Gustavo Dudamel|Gustavo Dudamel dirige "Carmen"|Herodias|Hippolyta|Hippolyta, Regina delle Amazzoni|James Conlon|Jeffrey Tate|Lev Dodin|Los Angeles|Manfred Schweigkofler|Opera di Roma|Pascal Dusapin|Paul Curran|Penthesilea|Peter Stein|Pierre Audi|Richard Strauss|Robert Carsen|Roma, Teatro dell'Opera|Sir Andrew Davis|Sonetka|Teatro San Carlo di Napoli|Teatro alla Scala|Théâtre La Monnaie|Venezia, Teatro La Fenice|Waltraute|Zita detta la vecchia
NANÀ MIRIANI|"Lady Macbeth del distretto di Mzesnk"|Aksin'ja|Dimitrij Sostakovic|Firenze, Teatro Comunale|James Conlon|Lev Dodin
WERNER VAN MECHELEN|"Götterdämmerung"|"Penthesilea"|-|Alberich|Franck Ollu|Jeffrey Tate|Odysseus|Pascal Dusapin|Pierre Audi|Robert Carsen|Théâtre La Monnaie|Venezia, Teatro La Fenice
EVA OLTIVANYI|"Götterdämmerung"|-|Jeffrey Tate|Robert Carsen|Venezia, Teatro La Fenice|Woglinde
GABRIEL SUOVANEN|"Götterdämmerung"|-|Gunther|Jeffrey Tate|Robert Carsen|Venezia, Teatro La Fenice
ANNETTE JAHNS|"Die Walküre"|"Die Zauberflöte"|"Götterdämmerung"|-|Erste Norn|Flosshilde|Gabriele Ferro|Graham Vick|Jeffrey Tate|Le tre dame|Palermo, Teatro Massimo|Pietari Inkinen|Robert Carsen|Roberto Andò|Schwertleite|Stefan Anton Reck|Teatro Massimo di Palermo|Venezia, Teatro La Fenice|Wolfgang Amadeus Mozart
CERI WILLIAMS|"Das Rheingold"|"Götterdämmerung"|-|Erda|Graham Vick|Jeffrey Tate|Palermo|Pietari Inkinen|Prima Norna|Robert Carsen|Venezia, Teatro La Fenice
ALEXANDRA WILSON|"Götterdämmerung"|-|Jeffrey Tate|Robert Carsen|Terza Norna|Venezia, Teatro La Fenice
DAVID DANIELS|"A midsummer night's dream"|"Orfeo ed Euridice", "Il Trovatore", "Rigoletto"|-|Antony Walker,Marco Armiliato,Fabio Luisi|David Mcvicar,Mark Morris,Otto Schenk|Giuseppe Verdi,Christoph Willibald Gluck|Metropolitan Opera|Oberon|Orfeo|Robert Carsen|Sir Andrew Davis|Teatro alla Scala
DANIEL OKULITCH|"A midsummer night's dream"|"Le nozze di Figaro"|-|Figaro|Ian Judge|Los Angeles|Placido Domingo|Robert Carsen|Sir Andrew Davis|Teatro alla Scala|Theseus|Wolfgang Amadeus Mozart
ADRIAN THOMPSON|"A midsummer night's dream"|"Da una casa di morti"|"Der Rosenkavalier"|"La volpe astuta"|-|David Mcvicar|Edward Gardner|Festival di Glyndebourne|Il Maestro / La Zanzara|Il detenuto grande|Leóš Janáček|Londra, English National Opera|Marko Letonja|Melly Still|Richard Strauss|Robert Carsen|Sir Andrew Davis|Strasburgo|Teatro alla Scala|Tom Snout|Valzacchi|Vladimir Jurowski
CHRISTOPHER GILLETT|"A midsummer night's dream"|"Il postino"|-|Francis Flute|Grant Gershon|Los Angeles|Robert Carsen|Ron Daniels|Sir Andrew Davis|Teatro alla Scala|Un sacerdote
BARBARA MASSARO|"A midsummer night's dream"|-|Mustardseed|Robert Carsen|Sir Andrew Davis|Teatro alla Scala
FILIPPO BETTOSCHI|"A Midsummer night's dream"|"Die Zauberflöte" (Il flauto magico)|"Don Carlo"|"La Traviata"|"Samson et Dalila"|Barone Douphol|Benjamin Britten|Brescia, Teatro Grande|Camille Saint-saëns|Carlo Montanaro|Carlus Padrissa/la Fura Dels Baus|Charles Dutoit|Daniele Gatti|Deputati fiamminghi|Eugenio Monti Colla|Giuseppe Verdi|James Conlon|Liliana Cavani|Milano, Teatro alla Scala|Oliver Gooch|Opera di Roma|Papageno|Paul Curran|Secondo Filisteo|Snug, stipettaio|Stephane Braunschweig|Teatro alla Scala|Wolfgang Amadeus Mozart
EKATERINA SADOVNIKOVA|"Die Zauberflöte"|"Falstaff"|"Idomeneo, re di Creta"|"Il Trittico" di Giacomo Puccini|"La traviata"|"Le nozze di Figaro"|"Pagliacci", "Gianni Schicchi"|"Rigoletto"|"Werther"|-|Alessandro Talevi|Antonello Manacorda|Catania|Damiano Michieletto|Daniel Harding|Daniele Abbado|Daniele Rustioni|Diego Matheuz|Due Amanti|Due amanti|Federico Grazzini|Firenze, Teatro del Maggio Musicale Fiorentino|Francesco Ivan Ciampa|Giacomo Puccini|Gilda|Giuseppe Verdi|Henning Brockhau|Il "Trittico" secondo Michieletto|Ilia|Jeffrey Tate|Jesùs Lopez-cobos|Jules Massenet|Lauretta|Luca Ronconi|Nannetta|Opera di Firenze|Opera di Roma|Pamina|Parma, Teatro Regio|Rani Calderon|Reggio Emilia, Teatro Valli|Robert Carsen|Roma, Teatro dell'Opera|Sergio Alapont|Sophie|Suor Genoveffa|Suor Genovieffa|Susanna|Theater an der Wien|Venezia, Teatro La Fenice|Violetta Valéry|Voce dal cielo|Willy Decker|Wolfgang Amadeus Mozart|Zubin Mehta|“Don Carlo”
ALESSIA NADIN|"Dido and Aeneas"|"Don Giovanni"|"Il Trittico" di Giacomo Puccini|"Il flauto magico"|"L'Italiana in Algeri"|"L'italiana in Algeri"|"La Cenerentola"|"Les contes d'Hoffmann"|"Norma"|"Tancredi"|-|Brescia, Teatro Grande|Christian Arming|Christian Capocaccia|Clotilde|Damiano Michieletto|Daniele Rustioni|Francesco Cilluffo|Francesco Frongia|Francesco Lanzillotta|Francesco Pasqualetti|Frédéric Roels|Giacomo Puccini|Giacomo Sagripanti|Gioachino Rossini|Graham Vick|Henry Purcell|Jacques Offenbach|José Luis Gomez-rios|La suora zelatrice|Marina Bianchi|Nicklausse|Padova, Teatro Verdi|Paolo Miccichè|Pavia, Teatro Fraschini|Pier Luigi Pizzi|Prima strega|Regio di Torino|Roberto Andò|Roggiero|Roma, Teatro dell'Opera|Rosetta Cucchi|Stefano Montanari|Teatro Fraschini di Pavia|Teatro Regio|Teatro Sociale di Como|Tisbe|Tiziano Severini|Verona|Verona, Teatro Ristori|Vincenzo Bellini|Vittorio Borrelli|Wolfgang Amadeus Mozart|Zerlina|Zulma|Zweite Dame
MATTHEW ROSE|"A midsummer night's dream"|-|Nick Bottom|Robert Carsen|Sir Andrew Davis|Teatro alla Scala
KIM BEGLEY|"Il prigioniero", "Il castello del duca Barbablù"|"Salome"|Béla Bartók|Daniel Harding|Gabriele Ferro|Herodes|Il grande Inquisitore|Manfred Schweigkofler|Milano, Teatro alla Scala|Peter Stein|Richard Strauss|Teatro San Carlo di Napoli
VLADIMIR  REUTOV|"Il Trittico" di Giacomo Puccini|Damiano Michieletto|Daniele Rustioni|Giacomo Puccini|Roma, Teatro dell'Opera|Un venditore di canzonette
PATRICIA RACETTE|"Il Trittico" di Giacomo Puccini|Damiano Michieletto|Daniele Rustioni|Giacomo Puccini|Giorgetta|Giorgietta|Il "Trittico" secondo Michieletto|Rani Calderon|Roma, Teatro dell'Opera|Suor Angelica|Theater an der Wien
WOOKYUNG KIM|"Salome"|Gabriele Ferro|Manfred Schweigkofler|Narraboth|Richard Strauss|Teatro San Carlo di Napoli
SAVERIO BAMBI|"Boris Godunov"|"I due Foscari"|"Il barbiere di Siviglia"|"Il viaggio a Reims"|"La Gioconda"|"La Vedova Allegra"|"Lady Macbeth del distretto di Mzesnk"|"Le nozze di Figaro"|"Lucia di Lammermoor"|"Madama Butterfly"|"Orfeo all'inferno"|"Roberto Devereux"|"Tosca"|-|Alessandro D’agostini|Amilcare Ponchielli|Barbarigo|Bologna, Teatro Comunale|Bruno Campanella|Cocchiere|Damiano Michieletto|Daniele Rustioni|Dimitrij Sostakovic|Don Curzio|Fabrizio Maria Carminati|Federico Tiezzi|Firenze, Palazzo Pitti|Firenze, Teatro Comunale|Francesco Bellotto|Franz Lehar|Gaetano Donizetti|Gelsomino|George Pehlivanian|Giacomo Puccini|Gioachino Rossini|Giudeppe Verdi|Goro|Graham Vick|Hirofumi Yoshida|Hugo De Ana|Isepo / Una voce|Jacques Offenbach|James Conlon|Jean Louis Grinda|Joseph Franconi Lee|Julian Kovatchev|Lev Dodin|Lord Cecil|Lucca, Teatro del Giglio|Marco Carniti|Marco Gandini|Mercurio|Michele Mariotti|Modest Musorgskij|Normanno|Opera di Firenze|Palermo, Teatro Massimo|Pordenone|Raoul de St.Brioche|Renato Palumbo|Renzo Giacchieri,Boldizsar Laszlo|Spoletta|Srboljub Dinic|Teatro Comunale di Bologna|Teatro Massimo di Palermo|Trieste|Un boiardo di corte / Il boiardo Chrušcëv|Un ufficiale|Valentina Brunetti|Verona, Teatro Filarmonico|Wolfgang Amadeus Mozart|Xu Zhong
ANTONIO MEZZASALMA|"Salome"|Ein Sklave|Gabriele Ferro|Manfred Schweigkofler|Richard Strauss|Teatro San Carlo di Napoli
JAVID SAMADOV|"Salome"|"Tristan und Isolde"|-|Ein Cappadocier|Gabriele Ferro|Manfred Schweigkofler|Marcus Bosch|Melot|Monique Wagemakers|Richard Strauss|Teatro Comunale "Pavarotti" di Modena|Teatro San Carlo di Napoli
JURGITA ADAMONYTE|"Salome"|Ein Page der Herodia|Gabriele Ferro|Manfred Schweigkofler|Richard Strauss|Teatro San Carlo di Napoli
LEO PAUL CHIAROT|"Il Trittico" di Giacomo Puccini|Damiano Michieletto|Daniele Rustioni|Giacomo Puccini|Pinellino|Roma, Teatro dell'Opera
ANNEMARIE KREMER|"Salome"|-|Gabriele Ferro|Giuseppe Verdi|Luisa|Manfred Schweigkofler|Markus Dietz|Richard Strauss|Salome|Teatro San Carlo di Napoli|Thomas Søndergård
GEORG NIGL|"Jakob Lenz"|"Lulu"|"Penthesilea"|"Von heute auf morgen", "Pagliacci"|-|Achilles|Alban Berg|Andrea Breth|Andreas Homoki|Arnold Schönberg|Bruxelles, Théâtre La Monnaie|Daniel Barenboim|Ein Athlet|Eliahu Inbal|Franck Ollu|Il marito|Jakob Lenz|Pascal Dusapin|Pierre Audi|Staatsoper Berlin|Staatsoper Stuttgart|Théâtre La Monnaie|Venezia, Teatro la Fenice|Wolfgang Rihm
ERIKA BERETTI|"Il Trittico" di Giacomo Puccini|Damiano Michieletto|Daniele Rustioni|Giacomo Puccini|Roma, Teatro dell'Opera|Seconda cercatrice
MAXIM AKSENOV|"Il Trittico" di Giacomo Puccini|Damiano Michieletto|Daniele Rustioni|Giacomo Puccini|Luigi|Roma, Teatro dell'Opera
LORENZO GIAMBENEDETTI|"Il Trittico" di Giacomo Puccini|Damiano Michieletto|Daniele Rustioni|Gherardino|Giacomo Puccini|Roma, Teatro dell'Opera
ROSSELLA CERIONI|"Il Trittico" di Giacomo Puccini|Damiano Michieletto|Daniele Rustioni|Giacomo Puccini|La suora infermiera|Roma, Teatro dell'Opera
REUT VENTOTERO|"Il Trittico" di Giacomo Puccini|Damiano Michieletto|Daniele Rustioni|Giacomo Puccini|Roma, Teatro dell'Opera|Seconda conversa
SAVERIO FIORE|"A Midsummer night's dream"|"Aida"|"Die Zauberflote"|"Elektra"|"Falstaff"|"I Due Foscari"|"I puritani"|"Linda di Chamounix"|"Lucia di Lammermoor"|"Madama Butterfly"|"Moise et Pharaon"|"Nabucodonosor"|"Ola" per Rigoletto|"Otello" e "Tosca"|"Pagliacci"|"Roméo et Juliette"|"Simon Boccanegra"|"Tosca"|"Turandot"|"Un ballo in maschera"|-|Abdallo|Adrian Noble|Andrea Battistoni|Andrea Cigni|Arena Opera Festival|Arena di Verona|Aufide|Benjamin Britten|Brescia, Teatro Grande|Bruno Campanella|Bucklaw|Cagliari, Teatro Lirico|Cassio|Charles Gounod|Daniel Oren|David Mc Vicar|Dott. Cajus|Ein junger diener|Emilio Sagi|Erik Nielsen|Erster Priester|Fabio Ceresa|Fante del Consiglio dei Dieci|Ferzan Ozpetek|Firenze, Teatro Comunale|Firenze, Teatro del Maggio Musicale Fiorentino|Franco Zeffirelli|Gaetano Donizetti|Giacomo Puccini|Gioachino Rossini|Giorgio Ferrara|Giuliano Montaldo|Giuseppe Verdi|Giuseppe Verdi,Giacomo Puccini|Goro|Graham Vick|Hugo De Ana|Il Conte di Lerma/Un Araldo Reale|Ivo Guerra|James Conlon|Jean-paul Scarpitta|Lord Arturo</em> <em>Bucklaw|Lord Sir Bruno Roberton|L’Intendente del feudo|Marcello Mottadelli|Marco Armiliato,Marco Tonini|Mario Pontiggia,Mietta Corli|Matteo Beltrami|Matteo Borsa|Messaggero|Michael Balke|Michele Mariotti|Nikolaus Lenhoff|Non piangere'... c'è Liù|Opera di Firenze|Opera di Firenze, Opening Gala|Opera di Roma|Pang|Pang, gran cuciniere|Paolo Facincani,Andrea Battistoni,Armando Tasso|Paul Curran|Peppe / Arlecchino|Pier Luigi Pizzi|Pier’alli|Pinchas Steinberg|Pong|Pong, gran provveditore|Regio|Riccardo Frizza|Riccardo Muti|Richard Strauss|Roberto De Simone|Roma, Teatro dell'Opera|Roma,Teatro dell'Opera|Scienza e Belcanto all'Opera di Firenze|Sir Bruno Roberton|Spoletta|Stefan Soltesz|Teatro dell'Opera di Roma|Tom Snout, magnano|Torino|Torino, Teatro Regio|Tybalt|Un capitano del balestrieri|Un servo di Amelia|Verona, Teatro Filarmonico|Vincenzo Bellini|Werner Herzog|Wolfgang Amadeus Mozart|Zubin Mehta|“Don Carlo”|“I Puritani”
VSEVOLOD GRIVNOV|"Lady Macbeth del distretto di Mzesnk"|Dimitrij Sostakovic|Firenze, Teatro Comunale|James Conlon|Lev Dodin|Zinovij
NICOLA PAMIO|"Don Quichotte"|"Falstaff"|"Il Campiello" un "hit"|"Il Trittico" di Giacomo Puccini|"La Traviata"|"Nabucco"|"Rigoletto"|"Samson et Dalila"|"Tosca"|"Turandot"|-|Abdallo|Altoum|Angelo Bertini|Bardolfo|Camille Saint-saëns|Carlus Padrissa/la Fura Dels Baus|Charles Dutoit|Damiano Michieletto|Daniel Cohen,Marco Faelli|Daniele Gatti|Daniele Rustioni|Dmitri Tcherniakov|Doge|Dona Pasqua Polegana|Donato Renzetti|Ermanno Wolf-ferrari|Federico Tiezzi|Festival Pucciniano|Francesco Ivan Ciampa|Francesco Rosa|Gherardo|Giacomo Puccini|Gilbert Deflo|Giulio Ciabatti|Giuseppe|Giuseppe Verdi|Gustavo Dudamel|Il Tinca|Jules Massenet|Jürgen Flimm|Leo Muscato|Marcello Mottadelli|Marco Balderi|Matteo Borsa|Maurizio Scaparro|Milano, Teatro alla Scala|Muhai Tang|Opera di Roma|Palermo, Teatro di Verdura|Pang|Paolo Trevisi|Pasqua Polegana|Renzo Giacchieri|Rodriguez|Roma, Teatro dell'Opera|Salerno, Teatro Verdi|Sessantesimo Festival Puccini, Torre del Lago|Sociale di Rovigo|Spoletta|Stefano Romani|Teatro Lirico di Cagliari|Teatro alla Scala|Teatro alla Scala di Milano|Trieste, Teatro Verdi|Un Messagero Filisteo|Verona, Teatro Filarmonico|Willy Landin|“Otello” di Rossini
VLADIMIR VANEEV|"Lady Macbeth del distretto di Mzesnk"|Boris|Dimitrij Sostakovic|Firenze, Teatro Comunale|James Conlon|Lev Dodin|Vecchio forzato
ANDREA PORTA|"Il Trittico" di Giacomo Puccini|"La Bohème"|"La Traviata"|"Le nozze di Figaro"|"Madama Butterfly"|"Rusalka" al San Carlo di Napoli|Antonin Dvořák|Betto di Signa|Damiano Michieletto|Daniele Gatti|Daniele Rustioni|Dmitri Tcherniakov|Fano, Teatro della Fortuna|Figaro|Francesco Ivan Ciampa|Giacomo Puccini|Giuseppe Verdi|Guardacaccia|Il "Trittico" secondo Michieletto|Il marchese D’Obigny|Il principe Yamadori/Yakusidé|Jader Bignamini|John Fiore|Leo Muscato|Macerata Opera Festival|Manfred Schweigkofler|Marchese D’Obigny|Marco|Mario Martone|OperaLombardia,  Teatro Sociale di Como|Paolo Arrivabeni|Pierluigi Pizzi|Rani Calderon|Roma, Teatro dell'Opera|Schaunard|Sofia Coppola|Stefano Montanari|Teatro Fraschini di Pavia|Teatro alla Scala di Milano|Theater an der Wien|Tra attrazione e sventura|Wolfgang Amadeus Mozart
PERVIN CHAKAR|"Die Zauberflöte"|"L'Olimpiade"|"Lulu"|"Maria Stuarda"|-|Anna Kennedy|Bologna, Teatro Comunale|Daniele Abbado|Daniele Gatti|Denis Krief|Fabrizio Maria Carminati|Fenice di Venezia|Gaetano Donizetti|Josef Mysliveček|Ludek Golàt|Megacle|Oliver Von Dohànyi|Peter Stein|Petruzzelli di Bari|Prima dama|Roland B|Teatro alla Scala|Una quindicenne|Wolfgang Amadeus Mozart
CHRISTIAN HÜBNER|"Das Rheingold"|"Salome"|-|Fafner|Gabriele Ferro|Graham Vick|Manfred Schweigkofler|Palermo|Pietari Inkinen|Richard Strauss|Teatro San Carlo di Napoli|Zwei Soldaten
ROBERTO ACCURSO|"Carmen"|"Don Giovanni"|"Il Trittico" di Giacomo Puccini|"La Bohème"|"La Traviata"|"La fanciulla del West"|"Un ballo in maschera"|Alcindoro|Alex Ollé|Barone Douphol|Benoit|Bruxelles, Théâtre La Monnaie|Carlo Rizzi|Cristiano|Damiano Michieletto|Daniele Finzi Pasca|Daniele Gatti|Daniele Rustioni|Davide Livermore|Dmitri Tcherniakov|Gaetano D’espinosa|Georges Bizet|Giacomo Puccini|Giancarlo Del Monaco|Giuseppe Verdi|Il Barone Douphol|Jader Bignamini|Jake Wallace|Leporello|Marco|Maurizio Di Mattia|Mauro Roveri|Morales|Napoli, Teatro di San Carlo|Opéra de Monte-Carlo|Paco Azorin|Pinchas Steinberg|Roma, Teatro dell'Opera|Roma,Terme di Caracalla|Sassari, Teatro Comunale|Schaunard|Sofia Coppola|Teatro alla Scala di Milano|Torre del Lago|Wolfgang Amadeus Mozart|Zubin Mehta,Eleonora Buratto
MARKUS MARQUARDT|"Rigoletto"|"Salome"|"Siegfried"|-|Der Wanderer|Gabriele Ferro|Giuseppe Verdi|Jochanaan|Jossi Wieler|Jossi Wieler, Sergio Morabito|Manfred Schweigkofler|Marc Soustrot|Richard Strauss|Rigoletto|Staatsoper Stuttgart|Sylvain Cambreling|Teatro San Carlo di Napoli
ANTONIO POLI|"Die Zauberflöte"|"Il Trittico" di Giacomo Puccini|"L'elisir d'amore"|"La Traviata"|"Macbeth"|"Nabucodonosor"|-|Alfredo Germont|Antonello Manacorda|Damiano Michieletto|Daniel Harding|Daniele Abbado|Daniele Rustioni|Diego Matheuz|Don Ottavio,|Due amanti|Fenton|Francesco Lanzillotta|Gaetano Donizetti|Giacomo Puccini|Giuseppe Verdi|Il ritorno di "Don Giovanni"|Ismaele|Jader Bignamini|Jean-paul Scarpitta|Macduff|Nemorino, coltivatore, giovane semplice|Peter Stein|Petruzzelli di Bari|Riccardo Muti|Rinuccio|Robert Carsen|Roland B|Roma, Teatro dell'Opera|Saverio Marconi|Sofia Coppola|Tamino|Teatro della Fortuna di Fano|Venezia, Teatro La Fenice|Wolfgang Amadeus Mozart
FRANCESCO MUSINU|"Il Naso"|"Il Trittico" di Giacomo Puccini|"La Traviata"|"La battaglia di Legnano"|"Macbeth"|"Rigoletto"|"Roméo et Juliette"|"Salome"|-|Alcindoro|Alejo Perez|Andrea Battistoni|Andrea Cigni|Boris Brott|Brescia, Teatro Grande|Calixto Bieito|Carlo Montanaro|Charles Gounod|Conte di Ceprano|Damiano Michieletto|Daniele Rustioni|Dmitrij Šostakovič|Dottor Grenvil|Fabio Banfo|Ferzan Ozpetek|Gabriele Ferro|Georges Bizet|Giacomo Puccini|Giampaolo Maria Bisanti|Gianluigi Gelmetti|Gilbert Deflò|Giuseppe Verdi|Henning Brockhaus|Il conte di Ceprano|Il dottor Grenvil|Il primo console di Milano|James Conlon|La liberté!» Carmen al Regio di Torino|Liliana Cavani|Lorenzo Amato|Manfred Schweigkofler|Michael Balke|Napoli, Teatro di San Carlo|Nello Santi|Opera di Roma|Paris|Patrick Fournillier|Peter Stein|Richard Strauss|Roma, Teatro dell'Opera|Ruggero Cappuccio|Saverio Santoliquido,Yutaka Sado|Scala|Ser Amantio di Nicolao|Sesto domestico/Padre|Teatro San Carlo di Napoli|Teatro Verdi di Trieste|Teatro alla Scala|Torino, Teatro Regio|Trieste, Teatro Verdi|Un Sicario|Zuniga|Zwei Soldaten|«Et surtout la chose enivrante
ISABEL DE PAOLI|"Falstaff"|"Il Trittico" di Giacomo Puccini|"Il Trovatore"|"La Traviata"|-|Cristina Mazzavillani Muti|Damiano Michieletto|Daniele Rustioni|Flora Bervoix|Giacomo Puccini|Giuseppe Verdi|Ines|La maestra delle novizie|Mrs. Quickly|Nicola Paszkowski|Ravenna, Teatro Alighieri|Reggio Emilia, Teatro Valli|Roma, Teatro dell'Opera|Teatro delle Muse di Ancona
JULIE MELLOR|"Death in Venice"|"Götterdämmerung"|"Lucia di Lammermoor"|-|Alisa|Antonino Fogliani|Benjamin Britten|Bepi Morassi|Bruno Bartoletti|Gabriele Ferro|Gaetano Donizetti|Giuseppe Sinopoli|Jeffrey Tate|John Doyle|La mendicante|Lothar Zagrosek|Malwida von Meysenbug, La signora von Salomé|Pier Luigi Pizzi|Robert Carsen|Seconda Norna|Teresa|Venezia, Teatro La Fenice|Vincenzo Bellini
SIMGE BUYUKEDES|"Ernani"|"Il Trittico" di Giacomo Puccini|"Lucia di Lammermoor"|"Nabucodonosor"|"Simon Boccanegra"|-|Adrian Noble|Alisa|Anna|Damiano Michieletto|Daniele Rustioni|Gaetano Donizetti|Giacomo Puccini|Giovanna, di lei nutrice|Giuseppe Verdi|Hugo De Ana|Jean-paul Scarpitta|Nella|Opera di Roma|Prima cercatrice|Riccardo Muti|Roberto Abbado|Roma, Teatro dell'Opera|Teatro dell'Opera di Roma|Un’ancella di Amelia|la stagione lirica dell'Opera di Roma
VIOLETA URMANA|"Il Trittico" di Giacomo Puccini|"La forza del destino"|-|A Firenze una "Forza del destino"|Damiano Michieletto|Daniele Rustioni|Donna Leonora|Giacomo Puccini|Giuseppe Verdi|Jean-claude Auvray|La zia Principessa|Nicolas Joël|Parigi, Opéra|Roma, Teatro dell'Opera|’insegna del patriottismo
DOMENICO COLAIANNI|"Crispino e la Comare"|"Die Zauberflöte"|"DonTrastullo"|"Falstaff"|"Il Trittico" di Giacomo Puccini|"Il cappello di paglia di Firenze"|"La Bohème"|"La Traviata"|"La Vedova allegra"|"La muette de Portici"|"Tosca"|-|Alain Guingal|Alberto Veronesi|Alessandro Talevi|Alfred Eschwé|Bari, Teatro Petruzzelli|Benoit|Borella|Crispino|Damiano Michieletto|Daniel-francois-esprit Auber|Daniele Abbado|Daniele Rustioni|Don Trastullo|Elena Barbalich|Emma Dante|Fabio Mastrangelo|Federico Tiezzi|Ferzan Özpetek|Franco Zeffirelli|Franz Lehár|Giacomo Puccini|Giuseppe La Malfa|Giuseppe Verdi|Gustavo Dudamel|Hugo De Ana|Il Talpa|Il Visconte Cascada|Il marchese d’Obigny|Il sagrestano|Jader Bignamini|Luca Ronconi|Luigi E Federico Ricci|Martina Franca|Michele Mirabella|Milano, Teatro alla Scala|Napoli, Teatrino di Corte|Nino Rota|Nonancourt|Petruzzelli di Bari|Pistola|Riccardo Canessa|Roland B|Roma, Teatro dell'Opera|Rovigo, Teatro Sociale|Sagrestano|San Carlo di Napoli|Savona|Secondo armigero e una voce|Simone|Wolfgang Amadeus Mozart
MATHIAS HAUSMANN|"Carmen"|-|Daniel Barenboim|Emma Dante|Georges Bizet|Gustavo Dudamel|Gustavo Dudamel dirige "Carmen"|Los Angeles|Milano, Teatro alla Scala|Morales|Moralès|Teatro alla Scala
ELLIE DEHN|"A Midsummer night's dream"|"La Bohème"|"Le Nozze di Figaro"|"Les contes d'Hoffmann"|Antonia|Benjamin Britten|Daniele Rustioni|Franco Zeffirelli|Giacomo Puccini|Helena,innamorata di Demetrius|Jacques Offenbach|James Conlon|John Copley|La contessa|Marko Letonja|Milano, Teatro alla Scala|Musetta|Nicola Luisotti|Opera di Roma|Paul Curran|Robert Carsen|San Francisco|Wolfgang Amadeus Mozart
tag|Giacomo Puccini|38
tag|James Conlon|38
tag|Teatro alla Scala|33
tag|Robert Carsen|31
tag|Damiano Michieletto|30
tag|Daniele Rustioni|29
tag|Giuseppe Verdi|28
tag|Roma, Teatro dell'Opera|27
tag|"Il Trittico" di Giacomo Puccini|26
tag|Opera di Roma|24
tag|Firenze, Teatro Comunale|24
tag|Dimitrij Sostakovic|21
tag|Lev Dodin|21
tag|"Lady Macbeth del distretto di Mzesnk"|21
tag|Wolfgang Amadeus Mozart|20
tag|Peter Stein|19
tag|Benjamin Britten|19
tag|Paul Curran|19
tag|Richard Strauss|17
tag|Daniele Gatti|17
tag|"La Traviata"|17
tag|"A Midsummer night's dream"|17
tag|Sir Andrew Davis|16
tag|"A midsummer night's dream"|16
tag|Venezia, Teatro La Fenice|16
tag|Gabriele Ferro|15
tag|Manfred Schweigkofler|15
tag|"Lulu"|14
tag|Georges Bizet|14
tag|Jeffrey Tate|14
tag|Teatro San Carlo di Napoli|14
tag|"Götterdämmerung"|13
tag|Gustavo Dudamel|12
tag|"Salome"|12
tag|Los Angeles|11
tag|Hugo De Ana|10
tag|Andrea Battistoni|10
tag|"Tosca"|9
tag|Graham Vick|9
tag|Gustavo Dudamel dirige "Carmen"|9
tag|Milano, Teatro alla Scala|9
tag|Daniele Abbado|9
tag|Jader Bignamini|9
tag|Gaetano Donizetti|8
tag|"Rigoletto"|8
tag|Pascal Dusapin|8
tag|Théâtre La Monnaie|8
tag|Arena di Verona|8
tag|Pierre Audi|8
tag|"La Bohème"|8
tag|Bologna, Teatro Comunale|8
tag|Franck Ollu|8
tag|"Penthesilea"|8
tag|"Turandot"|7
tag|"Madama Butterfly"|7
tag|Teatro Massimo di Palermo|7
tag|Opera di Firenze|7
tag|Sofia Coppola|7
tag|"Le nozze di Figaro"|7
tag|Franco Zeffirelli|7
tag|"Die Zauberflöte"|7
tag|"Falstaff"|7
tag|Palermo, Teatro Massimo|6
tag|Zubin Mehta|6
tag|"Carmen"|6
tag|Gioachino Rossini|5
tag|Reggio Emilia, Teatro Valli|5
tag|Brescia, Teatro Grande|5
tag|"Nabucco"|5
tag|Verona, Teatro Filarmonico|5
tag|"Il Trovatore"|5
tag|"Macbeth"|5
tag|Andrea Cigni|5
tag|Gianandrea Noseda|5
tag|Torino, Teatro Regio|5
tag|"Lucia di Lammermoor"|5
tag|Renato Palumbo|5
tag|Stefano Montanari|5
tag|Henning Brockhaus|4
tag|Pinchas Steinberg|4
tag|Daniel Harding|4
tag|"Nabucodonosor"|4
tag|Dmitri Tcherniakov|4
tag|Rosetta Cucchi|4
tag|Spoletta|4
tag|Mario Martone|4
tag|Rani Calderon|4
tag|Trieste, Teatro Verdi|4
tag|Leo Muscato|4
tag|Il "Trittico" secondo Michieletto|4
tag|Jacques Offenbach|4
tag|Theater an der Wien|4
tag|Parma, Teatro Regio|4
tag|Davide Livermore|4
tag|Teatro alla Scala di Milano|4
tag|Riccardo Muti|4
tag|Diego Matheuz|4
tag|Carlo Montanaro|4
tag|Jean-paul Scarpitta|4
tag|Vincenzo Bellini|4
tag|Figaro|3
