FABRIZIO VON ARX|Alessandro De Marchi|Giovanni Battista Pergolesi|Pergolesi|Roberto De Simone|Roberto De Simone interpreta Pergolesi|Teatro San Carlo
ANNA MARIA DELL'OSTE|Alessandro De Marchi|Giovanni Battista Pergolesi|Megacle|Roberto De Simone|Roberto De Simone interpreta Pergolesi|Teatro San Carlo
BLANCA PORTILLO|Gustavo Tambascio|Madrid, Teatro Real|Narratrice|Pedro Halffter|Viktor Ullmann|“Der Kaiser von Atlantis” di Viktor Ullmann
TORBEN JÜRGENS|Gustavo Tambascio|Madrid, Teatro Real|Morte|Pedro Halffter|Viktor Ullmann|“Der Kaiser von Atlantis” di Viktor Ullmann
SONIA DE MUNCK|Bubikopf|Gustavo Tambascio|Madrid, Teatro Real|Pedro Halffter|Viktor Ullmann|“Der Kaiser von Atlantis” di Viktor Ullmann
ANGELA DENOKE|"Jenufa"|"L'Affare Makropulos"|"Parsifal"|"Věc Makropulos"|-|Calixto Bieito|Claus Guth|Emilia Marty|Firenze|Kostelnička Buryjovka|Kundry|Luca Ronconi|Marko Letonja|Mikko Franck|Milano, Teatro alla Scala|Staatsoper Stuttgart|Sylvain Cambreling|William Friedkin|Zubin Mehta|Zurigo,Opernhaus
KORA PAVELIC|"Reigen" di Philippe Boesmans|Das süße Mädel|Nicola Hümpel|Staatsoper Stuttgart
HUILING ZHU|"Les Dialogues des Carmélites"|-|Manfred Honeck|Staatsoper Stuttgart|Sœur Mathilde
MARCEL BEEKMAN|"L' ecume des Jours" di Edison Denisov|-|Der Priester|Der Seneschall|Jossi Wieler, Sergio Morabito|Pégase|Staatsoper Stuttgart|Sylvain Cambreling
AINSI VERWEY|"L' ecume des Jours" di Edison Denisov|-|Die Katze|Jossi Wieler, Sergio Morabito|Staatsoper Stuttgart|Sylvain Cambreling
JEANNE SEGUIN|"L' ecume des Jours" di Edison Denisov|-|Das Mädchen|Jossi Wieler, Sergio Morabito|Staatsoper Stuttgart|Sylvain Cambreling
YVES LENOIR|"L' ecume des Jours" di Edison Denisov|-|Der Apotheker|Jossi Wieler, Sergio Morabito|Schuppentier|Staatsoper Stuttgart|Sylvain Cambreling
HEINZ GÖHRIG|"I Puritani"|Giuliano Carella|Jossi Wieler E Sergio Morabito|Sir Bruno Robertson|Staatsoper Stuttgart
TOMASO SANTINON|"Leggenda"|Alessandro Solbiati|Gesù Cristo|Gianandrea Noseda|Stefano Poda|Torino, Teatro Carignano
URBAN MALMBERG|"Leggenda"|Alessandro Solbiati|Gianandrea Noseda|Grande Inquisitore|Stefano Poda|Torino, Teatro Carignano
NICOLETTA CABASSI, MICHIELE LIUZZI, SAX NICOSIA|"Leggenda"|Alessandro Solbiati|Gianandrea Noseda|Mimi ANDREA BALDASSARRI, STEFANO BOTTI|Stefano Poda|Torino, Teatro Carignano
LUCIANO BOTELHO|"La Sonnambula"|Elvino|Gabriele Ferro|Jussi Wieler, Sergio Morabito|Staatsoper Stuttgart|Vincenzo Bellini
ANA DURLOVSKY|"La Sonnambula"|"Les contes d'Hoffmann"|Altea|Amina|Christoph Marthaler|Gabriele Ferro|Jacques Offenbach|Jussi Wieler, Sergio Morabito|Olympia|Staatsoper Stuttgart|Vincenzo Bellini
MOTTI KASTÓN|"Die Zauberflöte"|Peter Konwitschny|Sprecher|Staatsoper Stuttgart|Uwe Sandner|Wolfgang Amadeus Mozart
ANDRÉ MORSCH|"Ariadne auf Naxos"|"Die Zauberflöte"|"La Bohème"|"Reigen" di Philippe Boesmans|"Tristan und Isolde"|-|Andrea Moses|Der Graf|Giacomo Puccini|Harlekin|Jossi Wieler, Sergio Morabito|Melot|Michael Schøwandt|Nicola Hümpel|Papageno|Peter Konwitschny|Richard Strauss|Schaunard|Simon Hewett|Staatsoper Stuttgart|Sylvain Cambreling|Uwe Sandner|Wolfgang Amadeus Mozart
PUMEZA MATSHIKIZA|"Die Zauberflöte"|"Falstaff"|"L' ecume des Jours" di Edison Denisov|-|Andreas Moses|Giuseppe Verdi|Isis, Freundin von Chloé|Jossi Wieler, Sergio Morabito|Nannetta|Pamina|Peter Konwitschny|Staatsoper Stuttgart|Sylvain Cambreling|Uwe Sandner|Wolfgang Amadeus Mozart
TORSTEN HOFMANN|"Der Rosenkavalier"|"Die Zauberflöte"|Monostatos|Peter Konwitschny|Staatsoper Stuttgart|Stefan Herheim|Uwe Sandner|Valzacchi|Wolfgang Amadeus Mozart
MARIA KORYAGOVA|"Ariadne auf Naxos"|"Die Zauberflöte"|"Nabucco"|Anna|Echo|Giuliano Carella|Giuseppe Verdi|Jossi Wieler, Sergio Morabito|Junge Papagena|Michael Schøwandt|Peter Konwitschny|Richard Strauss|Rudolf Frey|Staatsoper Stuttgart|Uwe Sandner|Wolfgang Amadeus Mozart
LAURYNA BENDZIUNAITE|"Jenufa"|-|Calixto Bieito|Karolka|Staatsoper Stuttgart|Sylvain Cambreling
LAMIA BEUQUE|"L'italiana in Algeri"|Bruno Campanella|Gioachino Rossini|Joan Font|Opera di Firenze|Zulma
NAOMI RHOMBERG|"Anna Bolena"|Elisabetta I|Gaetano Donizetti|Giancarlo Del Monaco|Massimo Zanetti|Zurigo, Opernhaus
KIM BEGLEY|"Il prigioniero", "Il castello del duca Barbablù"|"Salome"|Béla Bartók|Daniel Harding|Herodes|I|Il grande Inquisitore|Manfred Schweigkofler|Milano, Teatro alla Scala|Peter Stein|Teatro San Carlo di Napoli
MARIA RICCARDA WESSELING|"La Damnation de Faust"|Andrea Moses|Hector Berlioz|Kwamé Ryan|Marguerite|Staatsoper Stuttgart
ROBERY HAYWARD|"La Damnation de Faust"|Andrea Moses|Hector Berlioz|Kwamé Ryan|Méphistophélès|Staatsoper Stuttgart
ALOIS RIEDEL|"Der Rosenkavalier"|"La Bohème"|Andrea Moses|Giacomo Puccini|Parpignol|Simon Hewett|Staatsoper Stuttgart|Stefan Herheim|Un venditore di animali
HEIKO SCHULZ|"La Bohème"|Andrea Moses|Giacomo Puccini|Sergente dei Doganieri|Simon Hewett|Staatsoper Stuttgart
TOMMASO HAHN|"La Bohème"|Andrea Moses|Giacomo Puccini|Simon Hewett|Staatsoper Stuttgart|Un Doganiere
ALEXANDER EFANOV|"La Bohème"|Andrea Moses|Giacomo Puccini|Simon Hewett|Staatsoper Stuttgart|Un Venditore
TUOMAS PURSIO|"Elektra"|Johannes Knecht|Orest|Peter Konwitschny|Richard Strauss|Staatsoper Stuttgart
RENEE MORLOC|"Elektra"|Johannes Knecht|Klytämnestra|Peter Konwitschny|Richard Strauss|Staatsoper Stuttgart
BARBARA FRIEBEL|"Elektra"|Die Aufseherin|Johannes Knecht|Peter Konwitschny|Richard Strauss|Staatsoper Stuttgart
PHILIPP ALFONS HEITMANN|"Elektra"|Agamemnon|Johannes Knecht|Peter Konwitschny|Richard Strauss|Staatsoper Stuttgart
BARBARA SCHNEIDER-HOFSTETTER|"Elektra"|Elektra|Johannes Knecht|Peter Konwitschny|Richard Strauss|Staatsoper Stuttgart
TINA HORHOLD|"Elektra"|"Wozzeck"|-|Andrea Moses|Dritte Magd|Johannes Knecht|Margret|Michael Schønwandt|Peter Konwitschny|Richard Strauss|Staatsoper Stuttgart
MICHAELA SCHNEIDER|"Carmen"|"Les Dialogues des Carmélites"|-|Georges Bizet|Madame Lidoine|Manfred Honeck|Micaela|Patrick Fournillier|Sebastian Neubling|Staatsoper Stuttgart
YALUN ZHANG|"Maria Stuarda"|-|Gaetano Donizetti|Giorgio Talbot|Marc Soustrot|Staatsoper Stuttgart
SIMONE SCHNEIDER|" Götterdämmerung"|"Der Rosenkavalier"|"Don Giovanni"|"Elektra"|"Falstaff"|"Les contes d'Hoffmann"|"Maria Stuarda"|"Salome"|-|Altea|Andrea Moses|Andreas Moses|Antony Hermus|Christoph Marthaler|Chrysothemis|Die Feldmarschallin|Donna Anna|Gaetano Donizetti|Giulietta|Giuseppe Verdi|Gutrune|Jacques Offenbach|Johannes Knecht|Kirill Serebriannikov|Marc Soustrot|Maria Stuarda, regina di Scozia|Mrs. Alice Ford|Peter Konwitschny|Richard Strauss|Salome|Staatsoper Stuttgart|Stefan Herheim|Sylvain Cambreling|Wolfgang Amadeus Mozart
MARK MUNKITTRICK|"Carmen"|"Der Rosenkavalier"|"Jenufa"|"L' ecume des Jours" di Edison Denisov|"La Bohème"|"Madama Butterfly"|"Tosca"|-|Andrea Moses|Benoit|Calixto Bieito|Cesare Angelotti|Georges Bizet|Giacomo Puccini|Giuliano Carella|Jesus|Jossi Wieler, Sergio Morabito|Lo Zio Bonzo|Marko Letonja|Monique Wagemakers|Patrick Fournillier|Sebastian Neubling|Simon Hewett|Staatsoper Stuttgart|Stefan Herheim|Stárek|Sylvain Cambreling|Un Commissario di Polizia/Un Notaio|Willy Decker|Zuniga
ALEJANDRO MARCO-BUHRMESTER|Gustavo Tambascio|L’imperatore</em> <em>Overall|Madrid, Teatro Real|Overall|Pedro Halffter|Viktor Ullmann|“Der Kaiser von Atlantis” di Viktor Ullmann
CARMEN ANGULO|Danzatrici  CRISTINA ARIAS|Gustavo Tambascio|Madrid, Teatro Real|Pedro Halffter|Viktor Ullmann|“Der Kaiser von Atlantis” di Viktor Ullmann
TORSTEN HOFFMANN|"Madama Butterfly"|"Tristan und Isolde"|-|Ein Hirt|Giacomo Puccini|Giuliano Carella|Goro|Jossi Wieler, Sergio Morabito|Monique Wagemakers|Staatsoper Stuttgart|Sylvain Cambreling
MOTTI KASTÒN|"Tristan und Isolde"|-|Ein Steuermann|Jossi Wieler, Sergio Morabito|Staatsoper Stuttgart|Sylvain Cambreling
ROLAND BRACHT|"Falstaff"|"Fidelio"|"I Puritani"|"L' ecume des Jours" di Edison Denisov|"Les contes d'Hoffmann"|"Rigoletto"|"Wozzeck"|-|Altea|Andrea Moses|Andreas Moses|Bert Neumann|Christoph Marthaler|Doktor Mangemanche|Giuliano Carella|Giuseppe Verdi|Il Conte di Monterone|Il dottore|Jacques Offenbach|Jossi Wieler E Sergio Morabito|Jossi Wieler, Sergio Morabito|Lord Gualtiero Valton|Maître Luther / Crespel|Michael Schønwandt|Pistola|Rocco|Staatsoper Stuttgart|Sylvain Cambreling
JAN-CRISTOF TOMERL|"Wozzeck"|-|Andrea Moses|Il bambino di Marie|Michael Schønwandt|Staatsoper Stuttgart
CLAUDIO OTELLI|"Wozzeck"|-|Andrea Moses|Michael Schønwandt|Staatsoper Stuttgart|Wozzeck
CHRISTIANE IVEN|"Ariadne auf Naxos"|"Parsifal"|"Wozzeck"|-|Andrea Moses|Calixto Bieito|Jossi Wieler, Sergio Morabito|Kundry|Marie|Michael Schønwandt|Michael Schøwandt|Prima Donna / Ariadne|Richard Strauss|Staatsoper Stuttgart|Sylvain Cambreling
JUAN PABLO MARIN|"Fidelio"|Bert Neumann|Erster Gefangener|Jossi Wieler, Sergio Morabito|Staatsoper Stuttgart
ULRICH WAND|"Fidelio"|Bert Neumann|Jossi Wieler, Sergio Morabito|Staatsoper Stuttgart|Zweiter Gefangener
ASKAR ABDRAZAKOV|"Chovanščina"|"Nabucco"|-|Andrea Moses|Antonello Allemandi|Giuseppe Verdi|Padova, Teatro Verdi|Principe Ivan Chovànskij|Simon Hewett|Staatsoper Stuttgart|Stefano Poda|Zaccaria, gran pontefice degli ebrei
ARMALDO KLLOGJERI|"Nabucco"|Antonello Allemandi|Giuseppe Verdi|Ismaele, nipote di Sedecia, re di Gerusalemme|Padova, Teatro Verdi|Stefano Poda
CHRISTIAN FARAVALLI|"Nabucco"|Antonello Allemandi|Giuseppe Verdi|Gran sacerdote di Belo|Padova, Teatro Verdi|Stefano Poda
SORINA MUNTEANU|"Nabucco"|Abigaille, creduta figlia primogenita di Nabucco|Antonello Allemandi|Giuseppe Verdi|Padova, Teatro Verdi|Stefano Poda
SILVIA CELADIN|"Nabucco"|Anna, sorella di Zaccaria|Antonello Allemandi|Giuseppe Verdi|Padova, Teatro Verdi|Stefano Poda
SEBASTIAN KOHLHEPP|"Berenice, regina di Armenia" (Il Vologeso)|"Reigen" di Philippe Boesmans|Der junge Herr|Gabriele Ferro|Jossi Wieler|Lucio Vero|Niccolò Jommelli|Nicola Hümpel|Staatsoper Stuttgart
SEBASTIAN BOLLACHER|"La Juive"|Jacques Fromental Halévy|Jossi Wieler, Sergio Morabito|Staatsoper Stuttgart|Sébastien Rouland|Un araldo
GERGELY NÉMETI|"Anna Bolena"|"Der Rosenkavalier"|"Die Zauberflöte"|"Salome"|Gaetano Donizetti|Giancarlo Del Monaco|Kirill Serebriannikov|Lord Percy|Massimo Zanetti|Narraboth|Peter Konwitschny|Staatsoper Stuttgart|Stefan Herheim|Tamino|Un Cantante|Uwe Sandner|Wolfgang Amadeus Mozart|Zurigo, Opernhaus
ARNAUD RICHARD|"L' ecume des Jours" di Edison Denisov|"The Fairy Queen"|-|Calixto Bieito|Hymen|Jossi Wieler, Sergio Morabito|Nicolas, Colins Koch|Staatsoper Stuttgart|Sylvain Cambreling
SEBASTIEN DUTRIEUX|"Béatrice et Bénédict"|"L' ecume des Jours" di Edison Denisov|-|Bruxelles, Théâtre La Monnaie|Die Maus|Don Juan|Jossi Wieler, Sergio Morabito|Richard Brunel|Samuel Jean|Staatsoper Stuttgart|Sylvain Cambreling
LINDSAY AMMANN|" Götterdämmerung"|"Ariadne auf Naxos"|"Die Walküre"|-|Driade|Flosshilde|James Levine|Jossi Wieler, Sergio Morabito|Marc Soustrot|Metropolitan Opera|Michael Schøwandt|Peter Konwitschny|Richard Strauss|Robert Lepage|Rossweisse|Staatsoper Stuttgart
KARIN TORBJÖRNSDÓTTIR|"Jenufa"|"Rigoletto"|-|Calixto Bieito|Giuseppe Verdi|Jossi Wieler, Sergio Morabito|La contessa di Ceprano|Staatsoper Stuttgart|Sylvain Cambreling|Una serva
MARIA THERESA ULLRICH|"Jenufa"|"Les contes d'Hoffmann"|-|Altea|Calixto Bieito|Christoph Marthaler|Jacques Offenbach|La Moglie del Giudice|La Voix de la Tombe|Staatsoper Stuttgart|Sylvain Cambreling
GERGELY NEMÉTI|"Jenufa"|-|Calixto Bieito|Staatsoper Stuttgart|Sylvain Cambreling|Števa Buryja
ANTONIO MEZZASALMA|"Salome"|Ein Sklave|I|Manfred Schweigkofler|Teatro San Carlo di Napoli
WOOKYUNG KIM|"Salome"|I|Manfred Schweigkofler|Narraboth|Teatro San Carlo di Napoli
JURGITA ADAMONYTE|"Salome"|Ein Page der Herodia|I|Manfred Schweigkofler|Teatro San Carlo di Napoli
THOMAS ELWIN|"Chovanščina"|"Les contes d'Hoffmann"|-|Altea|Andrea Moses|Christoph Marthaler|Jacques Offenbach|Kuska|Nathanaël|Simon Hewett|Staatsoper Stuttgart
CHRISTIANNE STOTIJN|"Chovanščina"|-|Andrea Moses|Marfa|Simon Hewett|Staatsoper Stuttgart
ROBERT HOLZER, NICOLÒ CERIANI|"Salome"|I|Manfred Schweigkofler|Teatro San Carlo di Napoli|Zwei Nazarener
CHRISTIAN HÜBNER, FRANCESCO MUSINU|"Salome"|I|Manfred Schweigkofler|Teatro San Carlo di Napoli|Zwei Soldaten
DANIEL KALETA|"Chovanščina"|"Madama Butterfly"|-|Andrea Moses|Giacomo Puccini|Giuliano Carella|Monique Wagemakers|Primo Strelez|Simon Hewett|Staatsoper Stuttgart|Yakusidé
MATI TURI|"Chovanščina"|-|Andrea Moses|Principe Andrej Chovanskij|Simon Hewett|Staatsoper Stuttgart
HADAR HALEVY|"Iphigénie en Aulide" di Gluck|"Tancredi"|Alberto Zedda|Andrea Moses|Berlino, Deutsche Oper|Christoph Willibald Gluck|Clytemnestre|Cristoph Poppen|Gioachino Rossini|Pier Luigi Pizzi|Statsoper Stuttgart|Tancredi
ANDRÉ JUNG|"Ariadne auf Naxos"|Il maggiordomo|Jossi Wieler, Sergio Morabito|Michael Schøwandt|Richard Strauss|Staatsoper Stuttgart
KARL-FRIEDRICH DÜRR|"Ariadne auf Naxos"|Il professore di musica|Jossi Wieler, Sergio Morabito|Michael Schøwandt|Richard Strauss|Staatsoper Stuttgart
HEINZ GONZALO ARAYA|"Ariadne auf Naxos"|Jossi Wieler, Sergio Morabito|Michael Schøwandt|Richard Strauss|Scaramuccio|Staatsoper Stuttgart
THRMBINKOSI MGETYENGANA, THOMAS ELWIN|"Berenice, regina di Armenia" (Il Vologeso)|Due Servi|Gabriele Ferro|Jossi Wieler|Niccolò Jommelli|Staatsoper Stuttgart
JUDITH SCHMID|"Anna Bolena"|Gaetano Donizetti|Giancarlo Del Monaco|Massimo Zanetti|Smeton|Zurigo, Opernhaus
ASHLEY DAVID PREWETT|"Chovanščina"|"Rigoletto"|-|Andrea Moses|Giuseppe Verdi|Jossi Wieler, Sergio Morabito|Marullo|Simon Hewett|Staatsoper Stuttgart|Sylvain Cambreling|Švaklovitij
SASA VRABAC|"Chovanščina"|-|Andrea Moses|Secondo Strelez|Simon Hewett|Staatsoper Stuttgart
CLAUDIA MAHNKE|"Salome"|Herodias|Kirill Serebriannikov|Staatsoper Stuttgart
IDUNNU MÜNCH|"Salome"|Ein Page|Kirill Serebriannikov|Staatsoper Stuttgart
ESTHER DIERKES|"Salome"|Ein Sklave|Kirill Serebriannikov|Staatsoper Stuttgart
MARKO CILIC|"Ginevra di Scozia"|-|Bergamo, Teatro Donizetti|George Petrou|Giovanni Simone Mayr|Vafrino
PETER SCHÖNE|"Ginevra di Scozia"|-|Bergamo, Teatro Donizetti|George Petrou|Giovanni Simone Mayr|Il Re di Scozia
STEFANIE IRÁNYI|"Ginevra di Scozia"|-|Bergamo, Teatro Donizetti|George Petrou|Giovanni Simone Mayr|Lurcanio
MYRTÒ PAPATANASIU|"Ginevra di Scozia"|-|Bergamo, Teatro Donizetti|George Petrou|Ginevra|Giovanni Simone Mayr
VIRGIL MISCHOK|"Ginevra di Scozia"|-|Bergamo, Teatro Donizetti|George Petrou|Giovanni Simone Mayr|Il Gran Solitario di Scozia
RAFAEL ROJAS|"Madama Butterfly"|"Norma"|F.B. Pinkerton|Giacomo Puccini|Giuliano Carella|Ivan Anguélov|Jossi Wieler, Sergio Morabito|Monique Wagemakers|Pollione|Staatsoper Stuttgart|Vincenzo Bellini
CATHERINE NAGLESTAD|"Norma"|"Tosca"|Floria Tosca|Giacomo Puccini|Ivan Anguélov|Jossi Wieler, Sergio Morabito|Marko Letonja|Norma|Staatsoper Stuttgart|Vincenzo Bellini|Willy Decker
DANIEL KLUGE|"Ariadne auf Naxos"|"Chovanščina"|"Elektra"|"Fidelio"|"L' ecume des Jours" di Edison Denisov|"Norma"|"Reigen" di Philippe Boesmans|"Tosca"|"Tristan und Isolde"|-|Andrea Moses|Bert Neumann|Chick, Freund von Colin|Der Soldat|Ein junger diener|Flavio|Giacomo Puccini|Il maestro di ballo|Ivan Anguélov|Jaquino|Johannes Knecht|Jossi Wieler, Sergio Morabito|Lo Scrivano|Marko Letonja|Michael Schøwandt|Nicola Hümpel|Peter Konwitschny|Richard Strauss|Simon Hewett|Spoletta|Staatsoper Stuttgart|Stimme eines junges Seemans|Sylvain Cambreling|Vincenzo Bellini|Willy Decker
MARIA TOKARSKA|"Norma"|Clotilde|Ivan Anguélov|Jossi Wieler, Sergio Morabito|Staatsoper Stuttgart|Vincenzo Bellini
ERIN CAVES|"Ariadne auf Naxos"|"The Bassarids"|-|Da Lorca a Sotelo|Emperador / Prestidigitador|Hans Werner Henze|Jossi Wieler, Sergio Morabito|Mario Martone|Michael Schøwandt|Pablo Heras-casado|Richard Strauss|Robert Castro|Staatsoper Stuttgart|Stefan Soltesz|Teatro dell'Opera di Roma|Tenore / Bacchus|Tiresias|prima mondiale di “El Público” a Madrid
DAHEYUN AHN|"Ariadne auf Naxos"|Jossi Wieler, Sergio Morabito|Michael Schøwandt|Richard Strauss|Staatsoper Stuttgart|Un parrucchiere
HILKE  ANDERSEN|"Falstaff"|Andreas Moses|Giuseppe Verdi|Mrs. Quickly|Staatsoper Stuttgart|Sylvain Cambreling
HEINZ G|"Falstaff"|Andreas Moses|Dott. Cajus|Giuseppe Verdi|Staatsoper Stuttgart|Sylvain Cambreling
MAGDALENA HINTERDOBLER|"Ginevra di Scozia"|-|Bergamo, Teatro Donizetti|Dalinda|George Petrou|Giovanni Simone Mayr
PAVEL CERNOCH|"Iolanta" e "Perséphone"|"Jenufa"|"La Damnation de Faust"|-|Andrea Moses|Calixto Bieito|Faust|Hector Berlioz|Kwamé Ryan|Laca Klemeň|Madrid, Teatro Réal|Peter Sellars|Pëtr Il’ic Cajkovskij,Igor Stravinskij|Staatsoper Stuttgart|Sylvain Cambreling|Teodor Currentzis|Vaudémont
KARIN HORVAT|"Der Rosenkavalier"|Staatsoper Stuttgart|Stefan Herheim|Una Modista
CLAUDIA VOTTELER, CRISTINA OTEY, GUDRUN WILMING|"Der Rosenkavalier"|Staatsoper Stuttgart|Stefan Herheim|Tre Nobili Orfane
FRIEDEMANN RÖHLIG|"Der Rosenkavalier"|Il Barone Ochs von Lerchenau|Staatsoper Stuttgart|Stefan Herheim
WOLFGANG SCHOENE|"Les Dialogues des Carmélites"|-|Manfred Honeck|Marquis de la Force|Staatsoper Stuttgart
ROMAN SHULACKOFF|"Les Dialogues des Carmélites"|-|Le Chevalier|Manfred Honeck|Staatsoper Stuttgart
HEINZ GOHRIG|"Les Dialogues des Carmélites"|-|Il cappellano|Manfred Honeck|Staatsoper Stuttgart
ERIC ANDER|"Chovanščina"|"Jakob Lenz"|"Les contes d'Hoffmann"|"Rigoletto"|-|Altea|Andrea Breth|Andrea Moses|Bass 2|Bruxelles, Théâtre La Monnaie|Christoph Marthaler|Franck Ollu|Giuseppe Verdi|Il Conte di Ceprano|Jacques Offenbach|Jossi Wieler, Sergio Morabito|Schlémil|Simon Hewett|Staatsoper Stuttgart|Sylvain Cambreling|Warssonofjew|Wolfgang Rihm
SUNHAE IM|"Die Zauberflöte"|"L'Opera Seria"|"Les Dialogues des Carmélites"|-|Accademia di Santa Cecilia|Bruxelles, Théâtre La Monnaie|Florian Leopold Gassmann|Manfred Honeck|Papagena|Patrick Kinmonth|Porporina|René Jacobs|Staatsoper Stuttgart|Sœur Constance|Wolfgang Amadeus Mozart
DAVID GÖHRIG|"Ariadne auf Naxos"|Jossi Wieler, Sergio Morabito|Michael Schøwandt|Richard Strauss|Staatsoper Stuttgart|Truffaldin
EWANDRO CRUZ-STENKOWSKI|"Ariadne auf Naxos"|Jossi Wieler, Sergio Morabito|Michael Schøwandt|Richard Strauss|Staatsoper Stuttgart|Un  ufficiale
ANA DURLOVSKI|"Ariadne auf Naxos"|"Berenice, regina di Armenia" (Il Vologeso)|"Der Rosenkavalier"|"Rigoletto"|Berenice|Gabriele Ferro|Gilda|Giuseppe Verdi|Jossi Wieler|Jossi Wieler, Sergio Morabito|Michael Schøwandt|Niccolò Jommelli|Richard Strauss|Sophie|Staatsoper Stuttgart|Stefan Herheim|Sylvain Cambreling|Zerbinetta
MATTHIAS KLINK|"Chovanščina"|"Reigen" di Philippe Boesmans|"Salome"|"Wunderzaichen" di Mark Andre in prima assoluta|-|Alvis Hermanis|Andrea Moses|Bernd Alois Zimmermann|Der Dichter|Der junge Graf|Herodes|Ingo Metzmacher|Jossi Wieler, Sergio Morabito|Kirill Serebriannikov|Mark Andre|Nicola Hümpel|Polizist / Erzengel|Principe Vasilij Golitzyn|Simon Hewett|Staatsoper Stuttgart|Sylvain Cambreling|“Die Soldaten” al Teatro alla Scala
CLARON MCFADDEN|"Shell Schock"|Bruxelles, Théâtre La Monnaie|Koen Kessels|Nicholas Lens|Sidi Larbi Cherkaoui|Soprano
GERALD THOMPSON|"Shell Schock"|Bruxelles, Théâtre La Monnaie|Controtenore|Koen Kessels|Nicholas Lens|Sidi Larbi Cherkaoui
THEO LALLY, GABRIEL CROZIER|"Shell Schock"|Bruxelles, Théâtre La Monnaie|Koen Kessels|Nicholas Lens|Sidi Larbi Cherkaoui|Voci bianche GABRIEL KUTY
HELENA SCHNEIDERMANN|"Die glückliche Hand" e "Osud"|Jossi Wieler, Sergio Morabito|La signora Stuhlá|Leoš Janáček|Staatsoper Stuttgart|Stuhlá|Sylvain Cambreling
SYLVIA RENA ZIEGLER|"Die glückliche Hand" e "Osud"|"Elektra"|Johannes Knecht|Jossi Wieler, Sergio Morabito|Kosinská|Leoš Janáček|Peter Konwitschny|Richard Strauss|Staatsoper Stuttgart|Sylvain Cambreling|Zweite Magd
ELINOR SOHN|"Die glückliche Hand" e "Osud"|Jossi Wieler, Sergio Morabito|Leoš Janáček|Součková|Staatsoper Stuttgart|Sylvain Cambreling
REBECCA VON LIPINSKI|"Der Rosenkavalier"|"Die glückliche Hand" e "Osud"|"Don Giovanni"|"Elektra"|"Fidelio"|"Jenufa"|"L' ecume des Jours" di Edison Denisov|"Reigen" di Philippe Boesmans|-|Andrea Moses|Antony Hermus|Bert Neumann|Calixto Bieito|Chloé|Die junge Frau|Donna Elvira|Fünfte Magd|Jenufa|Johannes Knecht|Jossi Wieler, Sergio Morabito|Leonore (Fidelio)|Leoš Janáček|Marianne|Míla Válková|Nicola Hümpel|Peter Konwitschny|Richard Strauss|Staatsoper Stuttgart|Stefan Herheim|Sylvain Cambreling|Wolfgang Amadeus Mozart
SHIGEO ISHINO|" Götterdämmerung"|"Così fan tutte"|"Die glückliche Hand" e "Osud"|"Iphigénie en Aulide" di Gluck|"Platée"|"Reigen" di Philippe Boesmans|"Tristan und Isolde"|-|Agamemnon|Andrea Moses|Calixto Bieito|Christian Curnyn|Christoph Willibald Gluck|Cristoph Poppen|Der Gatte|Don Alfonso|Ein mann|Gunther|Jean-philippe Rameau|Jossi Wieler, Sergio Morabito|Kurvenal|Leoš Janáček|Marc Soustrot|Momus|Nicola Hümpel|Peter Konwitschny|Staatsoper Stuttgart|Statsoper Stuttgart|Sylvain Cambreling|Wolfgang Amadeus Mozart|Yannis Houvardas
MICHAEL EBBECKE|"Der Rosenkavalier"|"Die glückliche Hand" e "Osud"|"Jenufa"|"Madama Butterfly"|-|Calixto Bieito|Faninal|Giacomo Puccini|Giuliano Carella|Il Giudice|Jossi Wieler, Sergio Morabito|Konečný|Leoš Janáček|Monique Wagemakers|Sharpless|Staatsoper Stuttgart|Stefan Herheim|Sylvain Cambreling
YUN-JEONG LEE|"Die glückliche Hand" e "Osud"|Fanca Pacovská|Jossi Wieler, Sergio Morabito|Leoš Janáček|Staatsoper Stuttgart|Sylvain Cambreling
ANDRE' MORSCH|"Die glückliche Hand" e "Osud"|"La Cenerentola"|"Platée"|Andrea Moses|Calixto Bieito|Christian Curnyn|Dandini|Gioachino Rossini|Jean-philippe Rameau|Jossi Wieler, Sergio Morabito|José Luis Gomesz|Leoš Janáček|Staatsoper Stuttgart|Sylvain Cambreling|Un Satyre / Cithéron|Verva
ROBERTO ORTIZ|"Die glückliche Hand" e "Osud"|Jossi Wieler, Sergio Morabito|Leoš Janáček|Staatsoper Stuttgart|Sylvain Cambreling|Uno studente / Hrazda
ATALLA AYAN|"Falstaff"|"La Bohème"|"Nabucco"|"Rigoletto"|Andrea Moses|Andreas Moses|Fenton|Giacomo Puccini|Giuliano Carella|Giuseppe Verdi|Il Duca di Mantova|Ismaele|Jossi Wieler, Sergio Morabito|Rodolfo|Rudolf Frey|Simon Hewett|Staatsoper Stuttgart|Sylvain Cambreling
SEBASTIANA CATANA|"Nabucco"|Giuliano Carella|Giuseppe Verdi|Nabucco|Rudolf Frey|Staatsoper Stuttgart
HEINZ GÖHRIG, MARK MUNKITTRICK|"Parsifal"|-|Calixto Bieito|Cavalieri del Graal|Staatsoper Stuttgart|Sylvain Cambreling
MATTHIAS HÖLLE|"Parsifal"|-|Calixto Bieito|Staatsoper Stuttgart|Sylvain Cambreling|Titurel
MARTIN WINKLER|"Parsifal"|-|Calixto Bieito|Gustavo Tambascio|Klingsor|L’altoparlante|Madrid, Teatro Real|Pedro Halffter|Staatsoper Stuttgart|Sylvain Cambreling|Viktor Ullmann|“Der Kaiser von Atlantis” di Viktor Ullmann
TINA HÖRHOLD|"Parsifal"|-|Calixto Bieito|Staatsoper Stuttgart|Sylvain Cambreling|Una voce lontana
MARK MUNKITTRICK, KAI PREUSKER|"Wozzeck"|-|Andrea Moses|Due garzoni|Michael Schønwandt|Staatsoper Stuttgart
CLAUDIA BARAINSKY|"Wunderzaichen" di Mark Andre in prima assoluta|Jossi Wieler, Sergio Morabito|Maria|Mark Andre|Staatsoper Stuttgart|Sylvain Cambreling
CATRIONA  SMITH|"La Sonnambula"|Gabriele Ferro|Jussi Wieler, Sergio Morabito|Lisa|Staatsoper Stuttgart|Vincenzo Bellini
RONAN COLLET|"Nabucco"|Giuliano Carella|Giuseppe Verdi|Il Gran Sacerdote|Rudolf Frey|Staatsoper Stuttgart
CATHERINE FOSTER|"Nabucco"|Abigaille|Brünnhilde|Giuliano Carella|Giuseppe Verdi|Gran Teatre del Liceu di Barcelona|Josep Pons,Robert Carsen|Richard Wagner|Robert Carsen|Rudolf Frey|Staatsoper Stuttgart|“Siegfried”
KARL-FRIEDRICK DÜRR|"Tosca"|Giacomo Puccini|Marko Letonja|Sagrestano|Staatsoper Stuttgart|Willy Decker
STEPHAN STORCK|"Madama Butterfly"|"Tosca"|Giacomo Puccini|Giuliano Carella|Il Commissario Imperiale|Marko Letonja|Monique Wagemakers|Sciarrone|Staatsoper Stuttgart|Willy Decker
MARKUS MARQUARDT|"Rigoletto"|"Salome"|"Siegfried"|-|Der Wanderer|Giuseppe Verdi|I|Jochanaan|Jossi Wieler|Jossi Wieler, Sergio Morabito|Manfred Schweigkofler|Marc Soustrot|Rigoletto|Staatsoper Stuttgart|Sylvain Cambreling|Teatro San Carlo di Napoli
ILEANA MATEESCU|"Il Giustino"|-|Anastasio|Antonio Vivaldi|Parigi, Théatre des Champs Elysées|Stefano Molardi
SABINA PUERTOLAS|"Il Giustino"|-|Antonio Vivaldi|Leocasta|Parigi, Théatre des Champs Elysées|Stefano Molardi
VINCENT LESAGE|"Il Giustino"|-|Antonio Vivaldi|Parigi, Théatre des Champs Elysées|Polidarte|Stefano Molardi
JOSEFIN FEILER|"Fidelio"|"Siegfried"|"The Fairy Queen"|-|Bert Neumann|Calixto Bieito|Jossi Wieler|Jossi Wieler, Sergio Morabito|Marc Soustrot|Marzelline|Spring|Staatsoper Stuttgart|Waldvogel
THEMBINKOSI MGETYENGANA|"Rigoletto"|Giuseppe Verdi|Jossi Wieler, Sergio Morabito|Paggio della Duchessa|Staatsoper Stuttgart|Sylvain Cambreling
WILLIAM DAVID HALBERT|"Rigoletto"|Giuseppe Verdi|Jossi Wieler, Sergio Morabito|Staatsoper Stuttgart|Sylvain Cambreling|Usciere
RENATE BEHLE|"Elektra"|"Jenufa"|-|Calixto Bieito|Die Aufseherin / Die Vertraute|La vecchia Buryjovka|Maestro Del Coro|Patrice Ch|Richard Strauss|Staatsoper Stuttgart|Sylvain Cambreling|Teatro alla Scala di Milano
BOGDAN MIHAI|"La Cenerentola"|Andrea Moses|Don Ramiro|Gioachino Rossini|José Luis Gomesz|Staatsoper Stuttgart
MARIA TERESA ULLRICH|"La Cenerentola"|Andrea Moses|Gioachino Rossini|José Luis Gomesz|Staatsoper Stuttgart|Tisbe
MIRELLA BUNOAICA|"The Fairy Queen"|Calixto Bieito|Night|Staatsoper Stuttgart
MICHAEL STILLER|"The Fairy Queen"|Calixto Bieito|Oberon|Staatsoper Stuttgart
FRANK LASKE|"The Fairy Queen"|Calixto Bieito|Priest|Staatsoper Stuttgart
MAJA BECKMANN|"The Fairy Queen"|Calixto Bieito|Puck|Staatsoper Stuttgart
ALEXANDER SPRAGUE|"The Fairy Queen"|Calixto Bieito|Staatsoper Stuttgart|The Indian boy
SUSANNE BÖWE|"The Fairy Queen"|Calixto Bieito|Staatsoper Stuttgart|Titania
HELENE SCHNEIDERMAN|"Berenice, regina di Armenia" (Il Vologeso)|"La Sonnambula"|Gabriele Ferro|Jossi Wieler|Jussi Wieler, Sergio Morabito|Lucilla|Niccolò Jommelli|Staatsoper Stuttgart|Teresa|Vincenzo Bellini
MARC LAHO|"Le comte Ory"|"Les contes d'Hoffmann"|Altea|Christoph Marthaler|Frédéric Bélier-garcia|Gioachino Rossini|Hoffmann|Jacques Offenbach|Le Comte Ory|Opéra di Marsiglia|Roberto Rizzi Brignoli|Staatsoper Stuttgart
ALEX PENDA|"L'Opera Seria"|"Čerevički"|Bruxelles, Théâtre La Monnaie|Cagliari, Teatro Lirico|Donato Renzetti|Florian Leopold Gassmann|Oksana|Patrick Kinmonth|Pëtr Il’ič Čajkovskij|René Jacobs|Stonatrilla|Yuri Alexandrov
MANOLO BERTLING|"The Fairy Queen"|Calixto Bieito|Lysander|Staatsoper Stuttgart
CAROLINE JUNGHANNS|"The Fairy Queen"|Calixto Bieito|Hermia|Staatsoper Stuttgart
MARIO ZEFFIRI|"Ginevra di Scozia"|"L'Opera Seria"|"La gazza ladra"|-|Bergamo, Teatro Donizetti|Bruxelles, Théâtre La Monnaie|Damiano Michieletto|Florian Leopold Gassmann|George Petrou|Giannetto|Gioachino Rossini|Giovanni Battista Rigon|Giovanni Simone Mayr|Patrick Kinmonth|Polinesso|René Jacobs|Ritornello|Verona
ISOLDE DAUM, MAJA TABATADZE, CRISTINA OTEY|"Iphigénie en Aulide" di Gluck|Andrea Moses|Christoph Willibald Gluck|Cristoph Poppen|Statsoper Stuttgart|Troi Grecques
NORIKO KUINOSKY|"Iphigénie en Aulide" di Gluck|Andrea Moses|Christoph Willibald Gluck|Cristoph Poppen|Statsoper Stuttgart|Une esclave
RONAN|"Iphigénie en Aulide" di Gluck|Andrea Moses|Calchas|Christoph Willibald Gluck|Cristoph Poppen|Statsoper Stuttgart
MANDY FREDRICH|"Così fan tutte"|"Iphigénie en Aulide" di Gluck|Andrea Moses|Christoph Willibald Gluck|Cristoph Poppen|Fiordiligi|Iphigénie|Staatsoper Stuttgart|Statsoper Stuttgart|Sylvain Cambreling|Wolfgang Amadeus Mozart|Yannis Houvardas
CHRISTOPH KAIL|"Carmen"|Clown|Georges Bizet|Patrick Fournillier|Sebastian Neubling|Staatsoper Stuttgart
TIMOTHY RICHARDS|"Carmen"|"Rušalka"|Antonin Dvořák|Barrie Kosky|Don José|Georges Bizet|Henrik Nánási|Il principe|Komische Oper Berlin|Patrick Fournillier|Sebastian Neubling|Staatsoper Stuttgart
HEINZ GOEHRING|"Carmen"|"Wozzeck"|-|Andrea Moses|Dancaire|Georges Bizet|Il pazzo|Michael Schønwandt|Patrick Fournillier|Sebastian Neubling|Staatsoper Stuttgart
YUKO KAKUTA|"Ariadne auf Naxos"|"Carmen"|"Die Zauberflöte"|"Elektra"|"Jenufa"|"La Bohème"|"Platée"|-|Andrea Moses|Calixto Bieito|Christian Curnyn|Clarin|Frasquita|Georges Bizet|Giacomo Puccini|Jano|Jean-philippe Rameau|Johannes Knecht|Jossi Wieler, Sergio Morabito|Königin der Nacht|Michael Schøwandt|Musetta|Naiade|Patrick Fournillier|Peter Konwitschny|Richard Strauss|Sebastian Neubling|Simon Hewett|Staatsoper Stuttgart|Sylvain Cambreling|Uwe Sandner|Vierte Magd|Wolfgang Amadeus Mozart
ADAM KIM|"Carmen"|"Les Dialogues des Carmélites"|"Maria Stuarda"|-|Escamillo|Gaetano Donizetti|Georges Bizet|Il carceriere/Thierry/Dr. Javelinot|Lord Guglielmo Cecil|Manfred Honeck|Marc Soustrot|Patrick Fournillier|Sebastian Neubling|Staatsoper Stuttgart
ROSALIND PLOWRIGHT|"Die glückliche Hand" e "Osud"|"Les Dialogues des Carmélites"|-|Andreas Homoki|Hartmut Haenchen|Jossi Wieler, Sergio Morabito|La madre di Míla|Leoš Janáček|Madame de Croissy|Manfred Honeck|Mary|Richard Wagner|Staatsoper Stuttgart|Sylvain Cambreling
JUTTA BOHNERT|"Les Dialogues des Carmélites"|-|Blanche|Manfred Honeck|Staatsoper Stuttgart
KRISTIAN METZNER|"Tosca"|Giacomo Puccini|Marko Letonja|Staatsoper Stuttgart|Un carceriere|Willy Decker
RUPERT ENTICKNAP|"L'Opera Seria"|Bruxelles, Théâtre La Monnaie|Caverna|Florian Leopold Gassmann|Patrick Kinmonth|René Jacobs
MAGNUS STAVELAND|"L'Opera Seria"|Bragherona|Bruxelles, Théâtre La Monnaie|Florian Leopold Gassmann|Patrick Kinmonth|René Jacobs
NIKOLAY BORCHEV|"L'Opera Seria"|Bruxelles, Théâtre La Monnaie|Florian Leopold Gassmann|Passagallo|Patrick Kinmonth|René Jacobs
PIETRO SPAGNOLI|"L'Opera Seria"|"L'italiana in Algeri"|Bruno Campanella|Bruxelles, Théâtre La Monnaie|Delirio|Florian Leopold Gassmann|Gioachino Rossini|Joan Font|Mustafà|Opera di Firenze|Patrick Kinmonth|René Jacobs
ROBIN JOHANNSEN|"L'Opera Seria"|Bruxelles, Théâtre La Monnaie|Florian Leopold Gassmann|Patrick Kinmonth|René Jacobs|Smorfiosa
MANUEL GUNTHER|"Die sieben Todsünden"|Barrie Kosky|Berlino, Komische Oper|Bruder|Kristiina Poska|Kurt Weill
TIM KLASKI|"Die sieben Todsünden"|Barrie Kosky|Berlino, Komische Oper|Kristiina Poska|Kurt Weill|Mutter
ADAM CIOFFARI|"Ariadne auf Naxos"|"Die sieben Todsünden"|"Iphigénie en Aulide" di Gluck|Andrea Moses|Barrie Kosky|Berlino, Komische Oper|Bruder|Christoph Willibald Gluck|Cristoph Poppen|Jossi Wieler, Sergio Morabito|Kristiina Poska|Kurt Weill|Michael Schøwandt|Patrocle|Richard Strauss|Staatsoper Stuttgart|Statsoper Stuttgart|Un lacchè
IRMGARD VILSMAIER|" Götterdämmerung"|-|Brünnhilde|Marc Soustrot|Peter Konwitschny|Staatsoper Stuttgart
LINI GONG|" Götterdämmerung"|-|Marc Soustrot|Peter Konwitschny|Staatsoper Stuttgart|Woglinde
HELENE SCHNEIDERMANN|"Madama Butterfly"|Giacomo Puccini|Giuliano Carella|Monique Wagemakers|Staatsoper Stuttgart|Suzuki
CLAUDIA VOTTELER|"Madama Butterfly"|Giacomo Puccini|Giuliano Carella|La Zia|Monique Wagemakers|Staatsoper Stuttgart
INES MALAVAL|"Madama Butterfly"|Giacomo Puccini|Giuliano Carella|La Madre di Butterfly|Monique Wagemakers|Staatsoper Stuttgart
GERGELY NÈMETI|"Così fan tutte"|Ferrando|Staatsoper Stuttgart|Sylvain Cambreling|Wolfgang Amadeus Mozart|Yannis Houvardas
ANASTASIJA HARMS|"Madama Butterfly"|Dolore|Giacomo Puccini|Giuliano Carella|Monique Wagemakers|Staatsoper Stuttgart
SIMONE JACKEL|"Madama Butterfly"|Giacomo Puccini|Giuliano Carella|Kate Pinkerton|Monique Wagemakers|Staatsoper Stuttgart
MAJA TABATADZE|"Madama Butterfly"|Giacomo Puccini|Giuliano Carella|La Cugina|Monique Wagemakers|Staatsoper Stuttgart
LAURINA BENDZIUNAITE|"Reigen" di Philippe Boesmans|"The Fairy Queen"|Calixto Bieito|Die Dirne|Mistery|Nicola Hümpel|Staatsoper Stuttgart
GRAHAM F. VALENTINE|"Les contes d'Hoffmann"|Altea|Christoph Marthaler|Jacques Offenbach|Spalanzani|Staatsoper Stuttgart
ANDREA MELATH|"Les Dialogues des Carmélites"|-|Manfred Honeck|Mère Marie|Staatsoper Stuttgart
ALTEA GARRIDO|"Les contes d'Hoffmann"|Altea|Christoph Marthaler|Jacques Offenbach|Staatsoper Stuttgart|Stella
KARL-FRIEDRICH DURR|"Die glückliche Hand" e "Osud"|"L' ecume des Jours" di Edison Denisov|"La Juive"|-|Der Direktor der Waffenfabrik|Jacques Fromental Halévy|Jossi Wieler, Sergio Morabito|Leoš Janáček|Lhotský|Ruggiero|Staatsoper Stuttgart|Sylvain Cambreling|Sébastien Rouland
MASSIMO CAVALLETI|"Anna Bolena"|Gaetano Donizetti|Giancarlo Del Monaco|Lord Rocheford|Massimo Zanetti|Zurigo, Opernhaus
BOGDAN BACIU|"La Bohème"|Andrea Moses|Giacomo Puccini|Marcello|Simon Hewett|Staatsoper Stuttgart
PUMEZA  MATSHIKIZA|"La Bohème"|Andrea Moses|Giacomo Puccini|Mimi|Simon Hewett|Staatsoper Stuttgart
ADAM PALKA|"I Puritani"|"La Bohème"|Andrea Moses|Colline|Giacomo Puccini|Giuliano Carella|Jossi Wieler E Sergio Morabito|Simon Hewett|Sir Giorgio Valton|Staatsoper Stuttgart
BOYD OWEN|"L'italiana in Algeri"|Bruno Campanella|Gioachino Rossini|Joan Font|Lindoro|Opera di Firenze
JOSKA LEHTINEN|"Die sieben Todsünden"|Barrie Kosky|Berlino, Komische Oper|Kristiina Poska|Kurt Weill|Vater
ENZO CAPUANO|"La Cenerentola"|"La Traviata"|"Tannhäuser"|-|Andrea Moses|Bologna, Teatro Comunale|Carlo Montanaro|Don Magnifico|Gioachino Rossini|Giuseppe Verdi|Guy Montavon|Hermann, Landgraf von Thuringen|José Luis Gomesz|Liliana Cavani|Marchese d'Obigny|Staatsoper Stuttgart|Stefan Anton Reck|Teatro alla Scala
VARDUHI ABRAHAMYAN|"Il Giustino"|-|Andronico|Antonio Vivaldi|Parigi, Théatre des Champs Elysées|Stefano Molardi
ED LYON|"Il Giustino"|"L' ecume des Jours" di Edison Denisov|"Shell Schock"|-|Antonio Vivaldi|Bruxelles, Théâtre La Monnaie|Colin|Jossi Wieler, Sergio Morabito|Koen Kessels|Nicholas Lens|Parigi, Théatre des Champs Elysées|Sidi Larbi Cherkaoui|Staatsoper Stuttgart|Stefano Molardi|Sylvain Cambreling|Tenore|Vitaliano
JENS LARSEN|"Rušalka"|Antonin Dvořák|Barrie Kosky|Henrik Nánási|Komische Oper Berlin|Lo Spirito dell'acqua
CHRISTIANE OERTEL|"Rušalka"|Antonin Dvořák|Barrie Kosky|Henrik Nánási|Komische Oper Berlin|Lo sguattero
MÁTÉ GÁL|"Rušalka"|Antonin Dvořák|Barrie Kosky|Henrik Nánási|Komische Oper Berlin|Un cacciatore
ASMIK GRIGORIAN|"Rušalka"|Antonin Dvořák|Barrie Kosky|Henrik Nánási|Komische Oper Berlin|Rušalka, ninfa
URSULA HESSE VON DEN STEINEN|"Rušalka"|Antonin Dvořák|Barrie Kosky|Henrik Nánási|Komische Oper Berlin|La principessa straniera
AGNES ZWIERKO|"Rušalka"|Antonin Dvořák|Barrie Kosky|Henrik Nánási|Ježibaba, strega|Komische Oper Berlin
INGA KALNA, ANNA GREVELIUS, ISABELLE DRUET|"Die Zauberflöte"|-|Accademia di Santa Cecilia|René Jacobs|Tre Dame della Regina|Wolfgang Amadeus Mozart
JOACHIM BUHRMANN|"Die Zauberflöte"|-|Accademia di Santa Cecilia|René Jacobs|Secondo Sacerdote, Primo Armigero|Wolfgang Amadeus Mozart
TOPI LEHTIPUU|"Die Zauberflöte"|-|Accademia di Santa Cecilia|René Jacobs|Tamino|Wolfgang Amadeus Mozart
DANIEL SCHMUTZHARD|"Die Zauberflöte"|-|Accademia di Santa Cecilia|Papageno|René Jacobs|Wolfgang Amadeus Mozart
MARCOS FINK|"Die Zauberflöte"|"L'Opera Seria"|-|Accademia di Santa Cecilia|Bruxelles, Théâtre La Monnaie|Fallito|Florian Leopold Gassmann|Patrick Kinmonth|René Jacobs|Sarastro|Wolfgang Amadeus Mozart
JENICE GOLBOURNE|-|Federica d'Ostheim|Giuseppe Verdi|Markus Dietz|Thomas Søndergård
ANNEMARIE KREMER|"Salome"|-|Giuseppe Verdi|I|Luisa|Manfred Schweigkofler|Markus Dietz|Salome|Teatro San Carlo di Napoli|Thomas Søndergård
DIANE HALLER|"Nabucco"|-|Fenena|Giuliano Carella|Giuseppe Verdi|Laura|Markus Dietz|Rudolf Frey|Staatsoper Stuttgart|Thomas Søndergård
DMYTRO POPOV|-|Giuseppe Verdi|Markus Dietz|Rodolfo|Thomas Søndergård
ANDREY BREUS|-|Giuseppe Verdi|Markus Dietz|Miller|Thomas Søndergård
ATTILA JUN|" Götterdämmerung"|"Die Walküre"|"Norma"|"Parsifal"|"Siegfried"|"Tristan und Isolde"|-|Calixto Bieito|Deutsche Oper Berlin|Donald Runnicles|Fafner|Giuseppe Verdi|Gotz Friedrich|Gurnemanz|Hagen|Hunding|Ivan Anguélov|Jossi Wieler|Jossi Wieler, Sergio Morabito|Koenig Marke|König Marke|Magia|Marc Soustrot|Markus Dietz|Myung-whun Chung|Oroveso|Paul Curran|Peter Konwitschny|Staatsoper Stuttgart|Sylvain Cambreling|Thomas Søndergård|Vincenzo Bellini|Wurm|filtro, magia di Chung
BO YONG KIM|-|Giuseppe Verdi|Markus Dietz|Thomas Søndergård|Un contadino
TATIANA PECHNIKOVA|"La Juive"|Jacques Fromental Halévy|Jossi Wieler, Sergio Morabito|Rachel|Staatsoper Stuttgart|Sébastien Rouland
CATRIONA SMITH|"Berenice, regina di Armenia" (Il Vologeso)|"Chovanščina"|"La Cenerentola"|"La Juive"|-|Andrea Moses|Clorinda|Flavio|Gabriele Ferro|Gioachino Rossini|Jacques Fromental Halévy|Jossi Wieler|Jossi Wieler, Sergio Morabito|José Luis Gomesz|Niccolò Jommelli|Principessa Eudoxie|Simon Hewett|Staatsoper Stuttgart|Susanna|Sébastien Rouland
GILLES RAGON|"La Juive"|Eléazar|Jacques Fromental Halévy|Jossi Wieler, Sergio Morabito|Staatsoper Stuttgart|Sébastien Rouland
DMITRY TRUNOV|"La Juive"|Jacques Fromental Halévy|Jossi Wieler, Sergio Morabito|Principe Léopold|Staatsoper Stuttgart|Sébastien Rouland
LIANG LI|"Die Zauberflöte"|"La Juive"|"La Sonnambula"|"Nabucco"|"Rigoletto"|Alain Altinoglu|Gabriele Ferro|Giuliano Carella|Giuseppe Verdi|Il Cardinale Brogni|Il Commendatore|Il conte Rodolfo|Jacques Fromental Halévy|Jossi Wieler, Sergio Morabito|Jussi Wieler, Sergio Morabito|Michael Haneke|Parigi, Opéra Bastille|Peter Konwitschny|Rudolf Frey|Sarastro|Sparafucile|Staatsoper Stuttgart|Sylvain Cambreling|Sébastien Rouland|Uwe Sandner|Vincenzo Bellini|Wolfgang Amadeus Mozart|Zaccaria|“Don Giovanni”
KAI PREUSSKER|"Carmen"|"Les Dialogues des Carmélites"|-|Georges Bizet|Manfred Honeck|Morales|Patrick Fournillier|Sebastian Neubling|Staatsoper Stuttgart|Un ufficiale
HANS KITTELMANN|"Carmen"|Georges Bizet|Patrick Fournillier|Remendado|Sebastian Neubling|Staatsoper Stuttgart
DIANA HALLER|"Carmen"|"Così fan tutte"|"Elektra"|"I Puritani"|"La Cenerentola"|Andrea Moses|Angelina|Dorabella|Enrichetta di Francia|Erste Magd|Georges Bizet|Gioachino Rossini|Giuliano Carella|Johannes Knecht|Jossi Wieler E Sergio Morabito|José Luis Gomesz|Mercedes|Patrick Fournillier|Peter Konwitschny|Richard Strauss|Sebastian Neubling|Staatsoper Stuttgart|Sylvain Cambreling|Wolfgang Amadeus Mozart|Yannis Houvardas
MATTHIAS HOLLE|"Don Giovanni"|Andrea Moses|Antony Hermus|Il Commendatore|Staatsoper Stuttgart|Wolfgang Amadeus Mozart
ATALIA AYAN|"Don Giovanni"|Andrea Moses|Antony Hermus|Don Ottavio|Staatsoper Stuttgart|Wolfgang Amadeus Mozart
RONAN COLLETT|"Così fan tutte"|"Don Giovanni"|Andrea Moses|Antony Hermus|Guglielmo|Masetto|Staatsoper Stuttgart|Sylvain Cambreling|Wolfgang Amadeus Mozart|Yannis Houvardas
ANDRE 'MORSCH|"Don Giovanni"|Andrea Moses|Antony Hermus|Leporello|Staatsoper Stuttgart|Wolfgang Amadeus Mozart
SOPHIE MARILLEY|"Ariadne auf Naxos"|"Berenice, regina di Armenia" (Il Vologeso)|"Der Rosenkavalier"|"Falstaff"|"Les contes d'Hoffmann"|"Platée"|Altea|Andreas Moses|Calixto Bieito|Christian Curnyn|Christoph Marthaler|Gabriele Ferro|Giuseppe Verdi|Il compositore|Jacques Offenbach|Jean-philippe Rameau|Jossi Wieler|Jossi Wieler, Sergio Morabito|Junon|La Muse / Nicklausse|Michael Schøwandt|Mrs. Meg Page|Niccolò Jommelli|Octavian|Richard Strauss|Staatsoper Stuttgart|Stefan Herheim|Sylvain Cambreling|Vologeso
PUMEZ MATSHIKISA|"Don Giovanni"|Andrea Moses|Antony Hermus|Staatsoper Stuttgart|Wolfgang Amadeus Mozart|Zerlina
THOMAS WALKER|"L'Opera Seria"|"Platée"|Bruxelles, Théâtre La Monnaie|Calixto Bieito|Christian Curnyn|Florian Leopold Gassmann|Jean-philippe Rameau|Patrick Kinmonth|Platée|René Jacobs|Sospiro|Staatsoper Stuttgart
ANDREAS WOLF|"Così fan tutte"|"Platée"|-|Calixto Bieito|Christian Curnyn|Guglielmo|Jean-philippe Rameau|Jupiter|Madrid, Teatro Real|Staatsoper Stuttgart|Sylvain Cambreling|Wolfgang Amadeus Mozart
CYRIL AUVITY|"Platée"|Calixto Bieito|Christian Curnyn|Jean-philippe Rameau|Staatsoper Stuttgart|Thespis / Mercure
REBECCA VON LIPINSKY|"Chovanščina"|"Platée"|-|Andrea Moses|Calixto Bieito|Christian Curnyn|Emma|Jean-philippe Rameau|Simon Hewett|Staatsoper Stuttgart|Thalie
MARK MILHOFER|"Leggenda"|"The Fairy Queen"|Alessandro De Marchi|Alessandro Solbiati|Aminta|Calixto Bieito|Gianandrea Noseda|Giovanni Battista Pergolesi|Ivan|Queen of Secresie|Roberto De Simone|Roberto De Simone interpreta Pergolesi|Staatsoper Stuttgart|Stefano Poda|Teatro San Carlo|Torino, Teatro Carignano
tag|Staatsoper Stuttgart|173
tag|Jossi Wieler, Sergio Morabito|61
tag|Sylvain Cambreling|58
tag|Andrea Moses|52
tag|Calixto Bieito|36
tag|Giuseppe Verdi|32
tag|Richard Strauss|27
tag|Giacomo Puccini|26
tag|Wolfgang Amadeus Mozart|26
tag|Peter Konwitschny|24
tag|Simon Hewett|23
tag|Giuliano Carella|23
tag|Bruxelles, Théâtre La Monnaie|16
tag|Michael Schøwandt|16
tag|"Ariadne auf Naxos"|16
tag|"Die Zauberflöte"|14
tag|"Salome"|14
tag|René Jacobs|14
tag|"Elektra"|13
tag|"L' ecume des Jours" di Edison Denisov|13
tag|"Chovanščina"|12
tag|Gioachino Rossini|12
tag|"Nabucco"|12
tag|"Madama Butterfly"|12
tag|"The Fairy Queen"|12
tag|"Der Rosenkavalier"|12
tag|Monique Wagemakers|12
tag|Johannes Knecht|12
tag|Stefan Herheim|12
tag|Manfred Honeck|11
tag|Leoš Janáček|11
tag|"La Bohème"|11
tag|Barrie Kosky|11
tag|"Die glückliche Hand" e "Osud"|11
tag|"Jenufa"|11
tag|"Les Dialogues des Carmélites"|11
