SALVATORE D'AGATA|"Lucia di Lammermoor"|"Stiffelio"|Antonino Manuli|Bellini di Catania|Catania|Emmanuel Plasson|Ezio Donato|Federico di Frengel, cugino di Lina|Gaetano Donizetti|Giuseppe Verdi|Guglielmo Ferro|Normanno
ELODIE KIMMEL|"Médée"|Cléone, 1ère bergère|Emmanuelle Haïm|Marc-antoine Charpentier|Parigi, Théâtre des Champs Elysées|Pierre Audi
SUSANNE BRAUNSTEFFER|"Der Rosenkavalier"|Eine Modistin|Herbert Wernicke,Alejandro Stadler|Milano, Teatro alla Scala|Philippe Jordan|Richard Strauss
MARTIN SNELL|"Der Rosenkavalier"|"Tannhäuser"|-|Bayreuther Festspiele|Christian Thielemann|Ein Notar|Herbert Wernicke,Alejandro Stadler|Milano, Teatro alla Scala|Philippe Jordan|Reinmar von Zweter|Richard Strauss
PETER SIDHOM|"Nixon in China"|Alexander Bridger|Chen Shi-zheng|Henry Kissinger|John Adams|Parigi, Théâtre du Châtelet
ALFRED KIM|"Nixon in China"|"Tosca"|Alexander Bridger|Chen Shi-zheng|Giacomo Puccini|John Adams|Mal Tse-tung|Mario Cavaradossi|Parigi, Théâtre du Châtelet|Pier Luigi Pizzi|Renato Palumbo|Roma, Terme di Caracalla
JUNE ANDERSON|"Nixon in China"|Alexander Bridger|Chen Shi-zheng|John Adams|Parigi, Théâtre du Châtelet|Pat, sua moglie
FRANCO POMPONI|"Nixon in China"|Alexander Bridger|Chen Shi-zheng|John Adams|Parigi, Théâtre du Châtelet|Richard Nixon
FREDERIC LEROY|"Il Trovatore"|-|Charles Roubaud|Giuseppe Verdi|Opéra di Marsiglia|Un Vecchio Zingaro
WILFRIED  TISSOT|"Il Trovatore"|-|Charles Roubaud|Giuseppe Verdi|Opéra di Marsiglia|Un messo
RICHARD BERKELEY-STEELE|"Tristan und Isolde"|-|Melot|Mikko Franck|Parigi, Salle Pleyel
RENAUD DERRIEN|"Tristan und Isolde"|-|Mikko Franck|Parigi, Salle Pleyel|Un pilota
ELLIE DEHN|"A Midsummer night's dream"|"La Bohème"|"Le Nozze di Figaro"|"Les contes d'Hoffmann"|Antonia|Benjamin Britten|Daniele Rustioni|Franco Zeffirelli|Giacomo Puccini|Helena,innamorata di Demetrius|Jacques Offenbach|James Conlon|John Copley|La contessa|Marko Letonja|Milano, Teatro alla Scala|Musetta|Nicola Luisotti|Opera di Roma|Paul Curran|Robert Carsen|San Francisco|Wolfgang Amadeus Mozart
MARLIS PETERSEN|"Le nozze di Figaro"|Ian Judge|Los Angeles|Placido Domingo|Susanna|Wolfgang Amadeus Mozart
BO SKOVHUS|"Le nozze di Figaro"|"The Rake's Progress"|-|Conte Almaviva|David Mcvicar|Gianandrea Noseda|Ian Judge|Igor Fëdorovič Stravinskij|Laurent Pelly|Los Angeles|Nick Shadow|Paul Daniel|Peter|Placido Domingo|Regio di Torino|Teatro Real di Madrid|Wolfgang Amadeus Mozart|“Hänsel und Gretel”
MARTINA SERAFIN|"Le nozze di Figaro"|"Tosca"|"Turandot"|Arena Opera Festival|Arena di Verona|Contessa  Almaviva|Daniel Oren|Elisabetta di Valois|Fabio Luisi|Firenze, Teatro Comunale|Floria Tosca|Franco Zeffirelli|Giacomo Puccini|Giuseppe Verdi|Hugo De Ana|Ian Judge|La Principessa Turandot|Los Angeles|Marco Armiliato,Marco Tonini|Mario Pontiggia|Milano, Teatro alla Scala|Pier Luigi Pizzi|Placido Domingo|Renato Palumbo|Roma, Terme di Caracalla|Stéphane Braunschweig|Tosca|Wolfgang Amadeus Mozart|“Don Carlo”
CHRISTOPHER GILLET|"Le nozze di Figaro"|Don Basilio|Ian Judge|Los Angeles|Placido Domingo|Wolfgang Amadeus Mozart
DANIEL MONTENEGRO|"La serva Padrona", "Trouble in Tahiti|"Le nozze di Figaro"|Don Curzio|Giovanni Battista Pergolesi|Ian Judge|Lawrence Edelson|Los Angeles|Mark Morash|Placido Domingo|Santa Barbara, California|Trio Tenor|Wolfgang Amadeus Mozart
VALENTINA FLEER|"Le nozze di Figaro"|Barbarina|Ian Judge|Los Angeles|Placido Domingo|Wolfgang Amadeus Mozart
RENATA POKUPIC|"Le nozze di Figaro"|Cherubino|Ian Judge|Los Angeles|Placido Domingo|Wolfgang Amadeus Mozart
ALESSANDRO GUERZONI|"Der Rosenkavalier"|"Falstaff"|"Le nozze di Figaro"|"Turandot"|-|Bologna, Teatro Comunale|Daniel Harding|Dottor Bartolo|Ein Polizeikommissär|Fabio Mastrangelo|Giacomo Puccini|Giuseppe Verdi|Herbert Wernicke,Alejandro Stadler|Ian Judge|Los Angeles|Milano, Teatro alla Scala|Philippe Jordan|Pistola|Placido Domingo|Richard Strauss|Robert Carsen|Roberto De Simone|Timur|Wolfgang Amadeus Mozart
DANIEL OKULITCH|"Le nozze di Figaro"|Figaro|Ian Judge|Los Angeles|Placido Domingo|Wolfgang Amadeus Mozart
REBECCA TEEM|"Die Walküre"|-|Deutsche Oper Berlin|Donald Runnicles|Gerhilde|Gotz Friedrich
ELAINE MCKRILL|"Die Walküre"|-|Deutsche Oper Berlin|Donald Runnicles|Gotz Friedrich|Helmwige
MARTINA WELSCHENBACH|"Die Walküre"|-|Deutsche Oper Berlin|Donald Runnicles|Gotz Friedrich|Ortlinde
JULIA BENZINGER|"Die Walküre"|-|Deutsche Oper Berlin|Donald Runnicles|Gotz Friedrich|Rossweisse
HEIDI MELTON|"Die Walküre"|-|Deutsche Oper Berlin|Donald Runnicles|Gotz Friedrich|Sieglinde
ROSWITHA C.MULLER|"Die Walküre"|-|Deutsche Oper Berlin|Donald Runnicles|Gotz Friedrich|Siegrune
PETER BRONDER|"Der Rosenkavalier"|"L'Affare Makropulos"|"Siegfried"|-|Conte Hauk-Sendorf|Graham Vick|Herbert Wernicke|Herbert Wernicke,Alejandro Stadler|Jeffrey Tate|Luca Ronconi|Madrid, Teatro Real|Madrid,Teatro Real|Marko Letonja|Milano, Teatro alla Scala|Mime|Philippe Jordan|Richard Strauss|Stefan Anton Reck|Teatro Massimo di Palermo|Valzacchi
JANE ARCHIBALD|"Der Rosenkavalier"|Herbert Wernicke,Alejandro Stadler|Milano, Teatro alla Scala|Philippe Jordan|Richard Strauss|Sophie
HOUARI LOPEZ ALDANA|"Der Rosenkavalier"|Herbert Wernicke|Jeffrey Tate|Madrid, Teatro Real|Madrid,Teatro Real|Richard Strauss|Un venditore di animali
TALIA OR|"Fidelio"|"Il flauto magico"|-|Accademia Nazionale di Santa Cecilia|Erste Dame|Gianandrea Noseda|Kirill Petrenko|Ludwig Van Beethoven|Mario Martone|Marzelline|Roberto Andò|Teatro Regio|Torino, Teatro Regio|Woglinde|“Das Rheingold”
PETER ROSE|"A Midsummer night's dream"|"Capriccio"|"Der Rosenkavalier"|"Tristan und Isolde"|-|Andrew Davis|Benjamin Britten|Der Baron Ochs|Herbert Wernicke,Alejandro Stadler|James Conlon|John Cox|La Roche|Metropolitan Opera|Mikko Franck|Milano, Teatro alla Scala|Nick Bottom, tessitore|Opera di Roma|Parigi, Salle Pleyel|Paul Curran|Philippe Jordan|Re Marke|Richard Strauss
ULRIKE HELZEL|"Die Walküre"|-|Accademia Nazionale di Santa Cecilia|Deutsche Oper Berlin|Donald Runnicles|Fricka|Gotz Friedrich|Kirill Petrenko|Waltraute|“Das Rheingold”
OFELIA SALA|"Der Rosenkavalier"|Herbert Wernicke|Jeffrey Tate|Madrid, Teatro Real|Madrid,Teatro Real|Richard Strauss|Sophie
TETYANA MELNYCHENKO|"Der Rosenkavalier"|Herbert Wernicke|Jeffrey Tate|Madrid, Teatro Real|Madrid,Teatro Real|Richard Strauss|Tre nobili orfane
CONSUELO GARRES|"Der Rosenkavalier"|Herbert Wernicke|Jeffrey Tate|Madrid, Teatro Real|Madrid,Teatro Real|Richard Strauss|Una modista
SCOTT WILDE|"Der Rosenkavalier"|"Lady Macbeth del distretto di Mzesnk"|"Lulu"|Alban Berg|Dimitrij Sostakovic|Ein Athlet|Hartmut Haenchen|Herbert Wernicke|Jeffrey Tate|Madrid, Teatro Real|Madrid,Teatro Real|Martin Kušej|Michael Schonwandt|Parigi, Opéra Bastille|Richard Strauss|Un commissario di polizia|Un ufficiale|Willy Decker
INGRID KAISERFELD|"Der Rosenkavalier"|Herbert Wernicke|Herbert Wernicke,Alejandro Stadler|Jeffrey Tate|Jungfer Marianne Leitmetzerin|Madrid, Teatro Real|Madrid,Teatro Real|Marianne|Milano, Teatro alla Scala|Philippe Jordan|Richard Strauss
JOYCE DI DONATO|"Der Rosenkavalier"|Herbert Wernicke|Jeffrey Tate|Madrid, Teatro Real|Madrid,Teatro Real|Octavian|Richard Strauss
JOSE' ALBERTO GARCIA|"Der Rosenkavalier"|Herbert Wernicke|Jeffrey Tate|Madrid, Teatro Real|Madrid,Teatro Real|Quattro camerieri|Richard Strauss
GAIZKA GURRUCHAGA|"Der Rosenkavalier"|Herbert Wernicke|Jeffrey Tate|Madrid, Teatro Real|Madrid,Teatro Real|Quattro Lacchè della Marescialla|Richard Strauss
IVO STANCHEV|"Der Rosenkavalier"|Herbert Wernicke|Jeffrey Tate|Madrid, Teatro Real|Madrid,Teatro Real|Richard Strauss|Un domestico
LYNTON BLACK|"Der Rosenkavalier"|Herbert Wernicke|Jeffrey Tate|Madrid, Teatro Real|Madrid,Teatro Real|Richard Strauss|Un notaio
CLEMENTINE MARGAINE|"Die Walküre"|"Tancredi"|-|Alberto Zedda|Berlino, Deutsche Oper|Deutsche Oper Berlin|Donald Runnicles|Gioachino Rossini|Gotz Friedrich|Gringerde|Isaura|Pier Luigi Pizzi
JOSEP FADO'|"Der Rosenkavalier"|Herbert Wernicke|Jeffrey Tate|Madrid, Teatro Real|Madrid,Teatro Real|Maggiordomo di Faninal|Richard Strauss
ANGEL RODRIGUEZ|"Der Rosenkavalier"|Herbert Wernicke|Jeffrey Tate|Madrid, Teatro Real|Madrid,Teatro Real|Maggiordomo della Marescialla|Richard Strauss
FRANZ HAWLATA|"Das Rheingold"|"Der Rosenkavalier"|"Die Walküre"|"Fidelio"|-|Gianandrea Noseda|Graham Vick|Herbert Wernicke|Il Barone Ochs|Jeffrey Tate|Ludwig Van Beethoven|Madrid, Teatro Real|Madrid,Teatro Real|Mario Martone|Palermo|Pietari Inkinen|Richard Strauss|Rocco|Teatro Massimo di Palermo|Torino, Teatro Regio|Wotan
LAURENT NAOURI|"Der Rosenkavalier"|"Les contes d'Hoffmann"|"Médée"|"Pelléas et Mélisande"|Claude Debussy|Créon|Emmanuelle Haïm|Faninal|Golaud|Herbert Wernicke|Jacques Offenbach|Jeffrey Tate|Lindorf, Coppelius, Dapertutto, Miracle|Madrid, Teatro Real|Madrid,Teatro Real|Marc-antoine Charpentier|Marko Letonja|Milano, Teatro alla Scala|Parigi, Théâtre des Champs Elysées|Pierre Audi|Richard Strauss|Robert Carsen|Robert Wilson|Sylvain Cambreling
CHRISTOPH HOMBERGER|"Der Rosenkavalier"|Herbert Wernicke|Jeffrey Tate|Locandiere|Madrid, Teatro Real|Madrid,Teatro Real|Richard Strauss
ANNE  SCHWANEWILMS|"Der Rosenkavalier"|Herbert Wernicke|Jeffrey Tate|La Marescialla|Madrid, Teatro Real|Madrid,Teatro Real|Richard Strauss
HILA FAHIMA|"Tancredi"|Alberto Zedda|Berlino, Deutsche Oper|Gioachino Rossini|Pier Luigi Pizzi|Roggiero
PIERO TERRANOVA|"Lucia di Lammermoor"|Catania|Emmanuel Plasson|Gaetano Donizetti|Guglielmo Ferro|Lord Enrico Ashton
NICOLAS TESTE'|"Il Trovatore"|"Les contes d'Hoffmann"|-|Charles Roubaud|Ferrando|Giuseppe Verdi|Hermann, Schlemil|Jacques Offenbach|Marko Letonja|Milano, Teatro alla Scala|Opéra di Marsiglia|Robert Carsen
VASSILIKI KARAYANNI|"Les contes d'Hoffmann"|Jacques Offenbach|Marko Letonja|Milano, Teatro alla Scala|Olympia|Robert Carsen
CHRISTIAN FRANZ|"Tristan und Isolde"|-|Mikko Franck|Parigi, Salle Pleyel|Tristan
PASCAL BOURGEOIS*|"Tristan und Isolde"|-|Mikko Franck|Parigi, Salle Pleyel|Un giovane marinario
CHRISTOPHE PONCET*|"Tristan und Isolde"|-|Mikko Franck|Parigi, Salle Pleyel|Un pastore
KARINA GAUVIN|-|Maxim Emelyanychev|Partenope|’Auditorio Nacional di Madrid|“Partenope” di Händel
VICTOR SICARD|-|Maxim Emelyanychev|Ormonte|’Auditorio Nacional di Madrid|“Partenope” di Händel
JOHN MARK AINSLEY|-|Emilio|Maxim Emelyanychev|’Auditorio Nacional di Madrid|“Partenope” di Händel
CHRISTOF FISCHESSER|"Tannhäuser"|-|Hermann|Parigi, Opéra Bastille|Robert Carsen|Sir Mark Elder
WOJTEK SMILEK|"Aida"|"Tannhäuser"|-|Alberto Hold-garrido|Giuseppe Verdi|Opéra di Toulon|Parigi, Opéra Bastille|Paul Emile Fourny|Ramfis|Reinmar von Zweter|Robert Carsen|Sir Mark Elder
STÉPHANE DEGOUT|"Médée"|"Tannhäuser"|-|Emmanuelle Haïm|Marc-antoine Charpentier|Oronte, un chef des habitants, un berger|Parigi, Opéra Bastille|Parigi, Théâtre des Champs Elysées|Pierre Audi|Robert Carsen|Sir Mark Elder|Wolfram von Eschenbach
ARTURO CHACON CRUZ|"Les contes d'Hoffmann"|Hoffmann|Jacques Offenbach|Marko Letonja|Milano, Teatro alla Scala|Robert Carsen
CYRILLE DUBOIS|"Le Saphir" di Félicien David|"Les contes d'Hoffmann"|-|Félicien David|Gaston|Jacques Offenbach|Marko Letonja|Milano, Teatro alla Scala|Nathanael|Robert Carsen|Venezia
ERIC HUCHET|"Tannhäuser"|-|Heinrich der Schreiber|Parigi, Opéra Bastille|Robert Carsen|Sir Mark Elder
NINA STEMME|"Tannhäuser"|"Tristan und Isolde"|-|Elisabeth|Isolde|Mikko Franck|Parigi, Opéra Bastille|Parigi, Salle Pleyel|Robert Carsen|Sir Mark Elder
MICHAEL KRANEBITTER|"Die Zauberflote"|David Mc Vicar|Erik Nielsen|Opera di Roma|Wolfgang Amadeus Mozart|Zweiter Priester
SCOTT WILD|"Die Zauberflote"|David Mc Vicar|Erik Nielsen|Opera di Roma|Wolfgang Amadeus Mozart|Zweiter Geharnischter Mann
MARIA ELENA PAPI*|"Die Zauberflote"|David Mc Vicar|Erik Nielsen|Opera di Roma|Wolfgang Amadeus Mozart|Zweiter Knabe
KATE ALDRICH|"La clemenza di Tito"|-|Madrid, Teatro Real|Mark Shanahan|Marsiglia, Opéra Municipal|Maxim Emelyanychev|Rosmira|Sesto|Thomas Hengelbrock|Ursel|Wolfgang Amadeus Mozart|’Auditorio Nacional di Madrid|“Partenope” di Händel
SARAH-JANE BRANDON|"Die Zauberflote"|David Mc Vicar|Erik Nielsen|Erste Dame|Opera di Roma|Wolfgang Amadeus Mozart
FRANCESCO BOVINO|"Die Zauberflote"|David Mc Vicar|Dritter Priester|Erik Nielsen|Opera di Roma|Wolfgang Amadeus Mozart
AUDREY LUNA|"Die Zauberflote"|David Mc Vicar|Erik Nielsen|Königin der Nacht|Opera di Roma|Wolfgang Amadeus Mozart
FLAVUA SCARLATTI|"Die Zauberflote"|David Mc Vicar|Erik Nielsen|Erster Knabe|Opera di Roma|Wolfgang Amadeus Mozart
SIBYLLA DUFFE|"Die Zauberflote"|David Mc Vicar|Erik Nielsen|Opera di Roma|Papagena|Wolfgang Amadeus Mozart
HANNA-ELISABETH MULLER|"Die Zauberflote"|David Mc Vicar|Erik Nielsen|Opera di Roma|Pamina|Wolfgang Amadeus Mozart
PETER LOBERT|"Die Zauberflote"|David Mc Vicar|Erik Nielsen|Opera di Roma|Sarastro|Wolfgang Amadeus Mozart
MARCUS WERBA|"Die Zauberflote"|David Mc Vicar|Erik Nielsen|Opera di Roma|Papageno|Wolfgang Amadeus Mozart
JUAN FRANCISCO GATEL|"Die Zauberflote"|David Mc Vicar|Erik Nielsen|Opera di Roma|Tamino|Wolfgang Amadeus Mozart
DETLEF ROTH|"Die Zauberflote"|"Tristan und Isolde"|-|David Mc Vicar|Erik Nielsen|Kurwenal|Mikko Franck|Opera di Roma|Parigi, Salle Pleyel|Sprecher|Wolfgang Amadeus Mozart
EMANUELA MARZI*|"Die Zauberflote"|David Mc Vicar|Dritter Knabe|Erik Nielsen|Opera di Roma|Wolfgang Amadeus Mozart
DANIELA SINDRAM|"Die Walküre"|"Les contes d'Hoffmann"|"The Turn of the Screw"|-|Benjamin Britten|David Mcvicar|Deutsche Oper Berlin|Donald Runnicles|Fricka|Gotz Friedrich|Jacques Offenbach|Josep Pons|La Muse, Nicklausse|Madrid,Teatro Real|Marko Letonja|Milano, Teatro alla Scala|Miss Jessel|Robert Carsen
FILIPPO BETTOSCHI|"A Midsummer night's dream"|"Die Zauberflöte" (Il flauto magico)|"La Traviata"|"Samson et Dalila"|Barone Douphol|Benjamin Britten|Brescia, Teatro Grande|Camille Saint-saëns|Carlo Montanaro|Carlus Padrissa/la Fura Dels Baus|Charles Dutoit|Eugenio Monti Colla|Giuseppe Verdi|James Conlon|Liliana Cavani|Oliver Gooch|Opera di Roma|Papageno|Paul Curran|Secondo Filisteo|Snug, stipettaio|Teatro alla Scala|Wolfgang Amadeus Mozart
AURÉLIA LEGAY|"Médée"|Emmanuelle Haïm|Marc-antoine Charpentier|Nérine, Bellone|Parigi, Théâtre des Champs Elysées|Pierre Audi
ANETT FRITSCH|"Così fan tutte"|-|Fiordiligi|Madrid, Teatro Real|Sylvain Cambreling|Wolfgang Amadeus Mozart
PETER SAVIDGE|"A Midsummer night's dream"|Benjamin Britten|James Conlon|Opera di Roma|Paul Curran|Theseus, Duca di Atene
GEORGE HUMPHREYS|"A Midsummer night's dream"|Benjamin Britten|James Conlon|Opera di Roma|Paul Curran|Robin Straveling, sarto
LAWRENCE ZAZZO|"A Midsummer night's dream"|-|Arsace|Benjamin Britten|James Conlon|Maxim Emelyanychev|Oberon, Re delle Fate|Opera di Roma|Paul Curran|’Auditorio Nacional di Madrid|“Partenope” di Händel
CAMILLA MALPICCI*|"A Midsummer night's dream"|Benjamin Britten|James Conlon|Moth, folletto,|Opera di Roma|Paul Curran
MICHAEL BATTEN|"A Midsummer night's dream"|Benjamin Britten|James Conlon|Opera di Roma|Paul Curran|Puck
PETER STRUMMER|"A Midsummer night's dream"|Benjamin Britten|James Conlon|Opera di Roma|Paul Curran|Peter Quince, falegname
ANTONY DEAN GRIFFEY|"A Midsummer night's dream"|Benjamin Britten|Francis Flute, acconciamantici|James Conlon|Opera di Roma|Paul Curran
SHAWN MATEY|"A Midsummer night's dream"|Benjamin Britten|James Conlon|Lysander, innamorato di Hermia|Opera di Roma|Paul Curran
TAMARA GURA|"A Midsummer night's dream"|Benjamin Britten|Hermia, innamorata di Lysander|James Conlon|Opera di Roma|Paul Curran
ALEXANDER KAIMBACHER|"Der Rosenkavalier"|"Die Zauberflote"|"Fidelio"|"Il flauto magico"|-|David Mc Vicar|Der Haushofmeister bei der Feldmarschallin|Erik Nielsen|Erster Geharnischter Mann|Gianandrea Noseda|Herbert Wernicke,Alejandro Stadler|Jaquino|Ludwig Van Beethoven|Mario Martone|Milano, Teatro alla Scala|Monostatos|Opera di Roma|Philippe Jordan|Richard Strauss|Roberto Andò|Teatro Regio|Torino, Teatro Regio|Wolfgang Amadeus Mozart
KURT AZESBERGER|"Der Rosenkavalier"|"Die Zauberflote"|"Die Zauberflöte" (Il Flauto Magico)|-|Accademia Nazionale di Santa Cecilia|Cagliari|Christopher Franklin|David Mc Vicar|Der Haushofmeister bei Faninal|Ein Wirt|Erik Nielsen|Herbert Wernicke,Alejandro Stadler|Kirill Petrenko|Milano, Teatro alla Scala|Mime|Monostato|Monostatos|Opera di Roma|Philippe Jordan|Richard Strauss|Roberto Andò|Wolfgang Amadeus Mozart|“Das Rheingold”
ANNE SCHWANEWILMS|"Der Rosenkavalier"|Die Feldmarschallin|Herbert Wernicke,Alejandro Stadler|Milano, Teatro alla Scala|Philippe Jordan|Richard Strauss
JIHAN SHIN|"Der Rosenkavalier"|"La donna del lago"|"Luisa Miller"|Bertram|Ein Tierhandler|Gianandrea Noseda|Gioachino Rossini|Giuseppe Verdi|Herbert Wernicke,Alejandro Stadler|Lluis Pasqual|Mario Martone|Milano, Teatro alla Scala|Philippe Jordan|Richard Strauss|Roberto Abbado|Un contadino
ALESSANDRO LIBERATORE|"Der Rosenkavalier"|"Elisabetta, regina d'Inghilterra"|"I Lombardi alla prima crociata"|"L'elisir d'amore"|"Lucia di Lammermoor"|"Nabucco"|-|Arena Sferisterio di Macerata|Arvino|Cagliari, Teatro Lirico|Catania|Daniele Callegari|Donato Renzetti|Emmanuel Plasson|Fabrizio Maria Carminati|Federico Ferri|Gaetano Donizetti|Gaetano D´espinosa|Gioachino Rossini|Giuseppe Verdi|Guglielmo Ferro|Herbert Wernicke|Ismaele|Jeffrey Tate|Leicester|Leo Muscato|Lord Arturo Bucklaw|Madrid, Teatro Real|Madrid,Teatro Real|Marco Spada|Michele Mirabella|Nemorino|Pier Luigi Pizzi|Richard Strauss|Roberto Abbado|Sassari, Teatro Comunale|Sir Edgardo di Ravenswood|Teatro Lirico di Cagliari|Teatro dell'Opera di Roma|Un cantante
ROMAN ASTAKHOV|"Rienzi"|-|Accademia Nazionale di Santa Cecilia|Fasolt|Hugo De Ana|Kirill Petrenko|Opera di Roma|Richard Wagner|Stefan Soltesz|Stefano Colonna|“Das Rheingold”
DIRK ALESCHUS|-|Accademia Nazionale di Santa Cecilia|Fafner|Kirill Petrenko|“Das Rheingold”
NINA BERNSTEINER|-|Accademia Nazionale di Santa Cecilia|Freia|Kirill Petrenko|“Das Rheingold”
HERMINE HASELBÖCK|-|Accademia Nazionale di Santa Cecilia|Flosshilde|Kirill Petrenko|“Das Rheingold”
ANDREA BÖNIG|-|Accademia Nazionale di Santa Cecilia|Erda|Kirill Petrenko|“Das Rheingold”
MARTIN TZONEV|-|Accademia Nazionale di Santa Cecilia|Donner|Kirill Petrenko|“Das Rheingold”
PETER GALLIARD|-|Accademia Nazionale di Santa Cecilia|Kirill Petrenko|Loge|“Das Rheingold”
ENDRIK WOTTRICH|-|Accademia Nazionale di Santa Cecilia|Froh|Kirill Petrenko|“Das Rheingold”
CARLOS ALMARGUER|"Il Trovatore"|-|Charles Roubaud|Conte di Luna|Giuseppe Verdi|Opéra di Marsiglia
CLAUDIA BOYLE|"A Midsummer night's dream"|Benjamin Britten|James Conlon|Opera di Roma|Paul Curran|Tytania, Regina delle Fate
WILLIAM SHIMELL|"Così fan tutte"|"Les contes d'Hoffmann"|-|Ancona, Teatro delle Muse|Crespel, Luther|Don Alfonso|Jacques Offenbach|Madrid, Teatro Real|Marko Letonja|Milano, Teatro alla Scala|Pierluigi Pizzi,Daniel Kawka|Robert Carsen|Sylvain Cambreling|Wolfgang Amadeus Mozart
DAGMAR PECKOVA|-|Accademia Nazionale di Santa Cecilia|Kirill Petrenko|Wellgunde|“Das Rheingold”
WOLFGANG KOCH|-|Accademia Nazionale di Santa Cecilia|Kirill Petrenko|Wotan|“Das Rheingold”
HERMINE MAY|"Les contes d'Hoffmann"|Jacques Offenbach|Marko Letonja|Milano, Teatro alla Scala|Robert Carsen|Une voix
GIUSEPPE COSTANZO|"Lucia di Lammermoor"|"Stiffelio"|Antonino Manuli|Bellini di Catania|Catania|Emmanuel Plasson|Ezio Donato|Gaetano Donizetti|Giuseppe Verdi|Guglielmo Ferro|Lord Arturo|Raffaele
CARL GHAZAROSSIAN|"Il Trovatore"|-|Charles Roubaud|Giuseppe Verdi|Opéra di Marsiglia|Ruiz
ADINA AARON|"Il Trovatore"|-|Charles Roubaud|Giuseppe Verdi|Leonora|Opéra di Marsiglia
HANS-JOACHIM KETELSEN|"Der Rosenkavalier"|Herbert Wernicke,Alejandro Stadler|Herr von Faninal|Milano, Teatro alla Scala|Philippe Jordan|Richard Strauss
JOYCE DIDONATO|"Der Rosenkavalier"|"I Capuleti e i Montecchi" fraintesi e sottovalutati|"La donna del lago"|Elena|Gioachino Rossini|Herbert Wernicke,Alejandro Stadler|Lluis Pasqual|Milano, Teatro alla Scala|Octavian|Philippe Jordan|Riccardo Frizza|Richard Strauss|Roberto Abbado|Romeo|San Francisco Opera|Vincent Boussard|Vincenzo Bellini.
DANIELLE DE NIESE|"Le Nozze di Figaro"|John Copley|Nicola Luisotti|San Francisco|Susanna|Wolfgang Amadeus Mozart
KRZYSZTOF  SZUMANSKI|"Tancredi"|Alberto Zedda|Berlino, Deutsche Oper|Gioachino Rossini|Orbazzano|Pier Luigi Pizzi
RONNITA NICOLE MILLERT|"Le nozze di Figaro"|Ian Judge|Los Angeles|Marcellina|Placido Domingo|Wolfgang Amadeus Mozart
tag|Wolfgang Amadeus Mozart|32
tag|"Der Rosenkavalier"|30
tag|Richard Strauss|30
tag|Opera di Roma|30
tag|Milano, Teatro alla Scala|23
tag|Madrid, Teatro Real|22
tag|Madrid,Teatro Real|20
tag|Herbert Wernicke|19
tag|Jeffrey Tate|19
tag|Erik Nielsen|16
tag|David Mc Vicar|16
tag|"Die Zauberflote"|16
tag|Robert Carsen|15
tag|Benjamin Britten|14
tag|Giuseppe Verdi|14
tag|Philippe Jordan|13
tag|Kirill Petrenko|13
tag|Accademia Nazionale di Santa Cecilia|13
tag|“Das Rheingold”|13
tag|James Conlon|13
tag|"A Midsummer night's dream"|13
tag|Herbert Wernicke,Alejandro Stadler|13
tag|Paul Curran|13
