MARKUS WERBA|"Die Zauberflöte"|"Die Zauberflöte" (Il Flauto Magico)|"Don Giovanni"|"Il flauto magico"|"La Bohème"|"La Vedova allegra"|"La vedova allegra"|"Pelléas et Mélisande"|-|Alfred Eschwé|Andrea Battistoni|Buenos Aires, Teatro Colón|Cagliari|Christopher Franklin|Claude Debussy|Damiano Michieletto,Luca Scarzella|Don Giovanni|Emmanuel Villaume|Federico Tiezzi|Franz Lehár|Gabriele Ferro|Giacomo Puccini|Gino Landi|Il Conte Danilo Danilowitch|Marcello|Olivia Fuchs|Papageno|Pelléas|Roberto Andò|Roberto Gianola|San Carlo di Napoli|Teatro La Fenice|Teatro Massimo di Palermo|Teatro Regio|Torino, Teatro Regio|Verona, Teatro Filarmonico|Vittorio Borrelli|Wolfgang Amadeus Mozart
MARIE-ANGE TODOROVITCH|"Der Fliegende Holländer"|"Elektra"|"L'Italiana in Algeri"|"La Chartreuse de Parme"|"Le comte Ory"|-|Charles Roubaud|Frédéric Bélier-garcia|Gina, duchesse de Sanseverina|Gioachino Rossini|Giuliano Carella|Henri Sauguet|Isabella|Klytämnestra|Lawrence Foster|Les Chorégies d'Orange|Mary, nutrice di Senta|Mikko Franck|Nicola Berloffa|Opéra de Marseille|Opéra di Marsiglia|Ragonde|Renée Auphan|Richard Strauss|Roberto Rizzi Brignoli
ANTOINE GARCIN|"La Chartreuse de Parme"|"Les Troyens"|-|Henri Sauguet|Lawrence Foster|Le Maréchal des logis / Un gendarme|Marsiglia, Opéra Municipal|Opéra de Marseille|Prètre de Pluton / 2ème sentinelle|Renée Auphan
JEAN-FRANCOIS BORRAS|"Roméo et Juliette"|"Turandot"|Andrea Cigni|Brescia, Teatro Grande|Charles Gounod|Charles Roubaud|Chorégies d'Orange|Giacomo Puccini|Michael Balke|Michel Plasson|Pong|Roméo
VERA CIRKOVIC|"Pelléas et Mélisande"|Buenos Aires, Teatro Colón|Claude Debussy|Emmanuel Villaume|Geneviève|Olivia Fuchs
MARC BARRARD|"L'Italiana in Algeri"|"La Bohème"|"Les Troyens"|"Pelléas et Mélisande"|"Turandot"|-|Buenos Aires, Teatro Colón|Charles Roubaud|Chorèbe /Le spectre de Chorèbe|Chorégies d'Orange|Claude Debussy|Emmanuel Villaume|Giacomo Puccini|Gioachino Rossini|Giuliano Carella|Golaud|Jean-louis Pichon|Lawrence Foster|Marcello|Mark Shanahan|Marsiglia, Opéra Municipal|Michel Plasson|Nicola Berloffa|Olivia Fuchs|Opéra de Marseille|Opéra di Marsiglia|Ping|Taddeo
FRÉDÉRIC ANTOUN|"L'Italiana in Algeri"|Gioachino Rossini|Giuliano Carella|Lindoro|Nicola Berloffa|Opéra di Marsiglia
CAROL GARCÍA|"L'Italiana in Algeri"|Gioachino Rossini|Giuliano Carella|Nicola Berloffa|Opéra di Marsiglia|Zulma
MARIE KALININE|"Le Saphir" di Félicien David|"Les Troyens"|-|Ascagne|Félicien David|La Regina/Lucrezia|Lawrence Foster|Marsiglia, Opéra Municipal|Venezia
ANNE-MARGUERITE WESTER|"Les Troyens"|-|Hécube /Polyxène|Lawrence Foster|Marsiglia, Opéra Municipal
IGOR GNIDII|"La Bohème"|"La fanciulla del West"|Giacomo Puccini|Giancarlo Del Monaco|Jean-louis Pichon|Mark Shanahan|Opéra de Marseille|Opéra de Monte-Carlo|Pinchas Steinberg|Schaunard|Sid
GABRIELLE PHILIPONET|"La Bohème"|"Le Saphir" di Félicien David|-|Félicien David|Giacomo Puccini|Hermine|Jean-louis Pichon|Mark Shanahan|Musetta|Opéra de Marseille|Venezia
NATHALIE MANFRINO|"La Bohème"|"La Chartreuse de Parme"|"La Traviata"|Clélia Conti|Giacomo Puccini|Giuseppe Verdi|Henri Sauguet|Hugo De Hana|Jean-louis Pichon|Lawrence Foster|Mark Shanahan|Mimì|Opéra de Marseille|Padova, Teatro Verdi|Renée Auphan|Steven Mercurio|Violetta Valéry
NICOLAS COURJAL|"La Bohème"|"Le comte Ory"|"Un ballo in maschera"|Alain Altinoglu|Colline|Frédéric Bélier-garcia|Giacomo Puccini|Gioachino Rossini|Giuseppe Verdi|Horn|Jean-claude Auvray|Jean-louis Pichon|Le gouverneur|Les Chorégies d'Orange|Mark Shanahan|Opéra de Marseille|Opéra di Marsiglia|Roberto Rizzi Brignoli
FRANCOIS CASTEL|"La Bohème"|Benoit|Giacomo Puccini|Jean-louis Pichon|Mark Shanahan|Opéra de Marseille
ROBERTO ALAGNA|"Don Carlo"|"Les Troyens"|"Turandot"|-|Calaf|Charles Roubaud|Chorégies d'Orange|Don Carlo|Enée|Giacomo Puccini|Giuseppe Verdi|Lawrence Foster|Marsiglia, Opéra Municipal|Michel Plasson|New York, Metropolitan Opera|Nicholas Hytner|Yannick Nézet-séguin
GREGORY WARREN|"Così fan tutte"|"Les Troyens"|-|Comunale di Sassari|Ferrando|Giovanni Battista Rigon|Iopas /Hylas|Jacopo Spirei|Lawrence Foster|Marsiglia, Opéra Municipal|Wolfgang Amadeus Mozart
WILFRIED TISSOT|"Aida"|"Les Troyens"|-|Charles Roubaud|Giuseppe Verdi|Helenus|Lawrence Foster|Marsiglia, Opéra Municipal|Pierre Iodice,Fabrizio Maria Carminati|Un messaggero|la nuova stagione lirica dell'Opéra di Marsiglia
BERNARD IMBERT|"Les Troyens"|-|Lawrence Foster|Marsiglia, Opéra Municipal|Un chef grec / 1ère sentinelle
ALEXANDRE DUHAMEL|"Les Troyens"|-|Alain Altinoglu|Lawrence Foster|Marsiglia, Opéra Municipal|Masetto|Michael Haneke|Panthée /Mercure|Parigi, Opéra Bastille|Wolfgang Amadeus Mozart|“Don Giovanni”
MARCO SPOTTI|"Aida"|"Benvenuto Cellini" di Hector Berlioz|"La Bohème"|"Norma"|"Rigoletto"|"Simon Boccanegra"|"Turandot"|-|Andrea De Rosa|Antonio Pappano|Arena di Verona|Arena di Verona 2008|Cesare Lievi|Charles Roubaud|Choregies Orange|Chorégies d'Orange|Colline|Daniele Rustioni|Ettore Scola|Festival Verdi 2008|Franco Zeffirelli|Franco Zeffirelli,Marco Gandini|Genova, Teatro Carlo Felice|Giacomo Puccini|Gianandrea Noseda|Giorgio Barberio Corsetti|Giuseppe Verdi|Hector Berlioz|Hugo De Ana|Il Re|Il grande Inquisitore|Il re d’Egitto|Ivo Guerra|Jacopo Fiesco|Jacopo Loredano|Jossi Wieler|Le Pape Clément VII|Marco Armiliato|Massimo Zanetti|Michel Plasson|Milano, Teatro|Milano, Teatro alla Scala|Myung Whun Chung|Nadine Duffaut|Omer Meir Wellber|Oroveso, capo dei druidi|Perché re|Ramfis|Regio|Renato Palumbo|Roberto Abbado|Roma, Accademia Nazionale di Santa Cecilia|Scala'..."Aida"'...impressioni in "generale"|Sessantesimo Festival Puccini, Torre del Lago|Sparafucile|Stefano Ranzani|Stefano Vizioli|Teatro Massimo di Palermo|Teatro alla Scala|Teatro dell'Opera di Roma|Terry Gilliam|Timur|Un "Don Carlo" in gran spolvero per “compleanno”|Valerio Galli|Valery Gergiev|Vincenzo Bellini|Will Humburg|ciel!»  Ancora Don Carlo a Torino|«Pronta a scoppiar la folgore|’“Aida” scaligera?
ALEX ESPOSITO|"Anna Bolena"|"Die Zauberflöte"|"Don Giovanni"|"L'Elisir d'amore"|"L'Italiana in Algeri"|"La clemenza di Tito" inaugura la nuova stagione|"La gazza ladra"|"Les contes d'Hoffmann"|"The rake's progress"|-|Alessandro Talevi|Altea|Ancona, Teatro delle Muse|Antonello Manacorda|Bergamo, Teatro Donizetti|Bruno Campanella|Christoph Marthaler|Corrado Rovaris|Damiano Michieletto|Damiano Michieletto,Luca Scarzella|Daniele Abbado|Davide Livermore|Diego Matheuz|Dulcamara|Enrico VIII|Faraone|Fernando|Gaetano Donizetti|Gioachino Rossini|Giuliano Carella|Graham Vick|Igor Stravinskij|Il Duca Alfonso|Ivo Van Hove|Jacques Offenbach|Josè Ramon Encinar|La Monnaie di Bruxelles|Leporello|Lindorf / Coppélius / Docteur Miracle / Dapertutto|Lodovic Morlot|Louis Langrée|Lü Ja|Marco Guidarini|Mustafà|Nick Shadow|Nicola Berloffa|Opera di Roma|Opéra di Marsiglia|Papageno|Pesaro, Rossini Opera Festival 2007|Peter Mussbach|Petruzzelli di Bari|Publio|ROF|Roberto Abbado|Roland B|Ruggero Cappuccio|Staatsoper Stuttgart|Stefano Montanari|Teatro La Fenice|Teatro La Fenice di Venezia|Teatro alla Scala|Venezia, Teatro La Fenice|Wolfgang Amadeus Mozart|una "Lucrezia Borgia" di successo
BEATRICE URIA-MONZON|"Les Troyens"|"Roberto Devereux"|-|Alain Guingal|Cassandre / Didon / Le spectre de Cassandre|Gaetano Donizetti|Lawrence Foster|Marsiglia, Opéra Municipal|Opéra de Marseille|Sara, sua moglie
SEBASTIANO DE FILIPPI|"Pelléas et Mélisande"|Buenos Aires, Teatro Colón|Claude Debussy|Emmanuel Villaume|Olivia Fuchs|Pastore
ANNE SOPHIE DUPRELS|"Pelléas et Mélisande"|Buenos Aires, Teatro Colón|Claude Debussy|Emmanuel Villaume|Mélisande|Olivia Fuchs
FABIOLA MASINO|"Pelléas et Mélisande"|Buenos Aires, Teatro Colón|Claude Debussy|Emmanuel Villaume|Olivia Fuchs|Yniold
MARIO DE SALVO|"Pelléas et Mélisande"|Buenos Aires, Teatro Colón|Claude Debussy|Emmanuel Villaume|Olivia Fuchs|Un medico
RICARDO BERNAL|"El gato montés"|"La Bohème"|"La Vedova Allegra"|-|Camille De Rossillon|Cristóbal Soler|Federico Tiezzi|Franz Lehar|Giacomo Puccini|Jean-louis Pichon|José Carlos Plaza|Julian Kovatchev|Madrid, Teatro de La Zarzuela|Mark Shanahan|Opéra de Marseille|Rafael|Rodolfo|Verona, Teatro Filarmonico
PATRICK DELCOUR|"L'Italiana in Algeri"|Gioachino Rossini|Giuliano Carella|Haly|Nicola Berloffa|Opéra di Marsiglia
LUC- BERTIN-HUGAULT|"Turandot"|Charles Roubaud|Chorégies d'Orange|Giacomo Puccini|Michel Plasson|Un Mandarino
FLORIAN LACONI|"Turandot"|Charles Roubaud|Chorégies d'Orange|Giacomo Puccini|Michel Plasson|Pang
MARIA LUIGIA BORSI|"La rondine"|"Madama Butterfly"|"Turandot"|Carlo Felice|Charles Roubaud|Chorégies d'Orange|Daniela Dess|Giacomo Puccini|Gino Zampieri|Liù|Lucca, Teatro del Giglio|Madama Butterfly|Madama Butterfly (Cio-Cio San)|Magda de Civry|Massimiliano Stefanelli|Michel Plasson|Sandro Pasqualetto|Valerio Galli
LISE LINDSTROM|"Salome"|"Turandot"|Angelo Bertini|Arena di Verona|Charles Roubaud|Chorégies d'Orange|Fabio Luisi|Franco Zeffirelli|Giacomo Puccini|La Principessa Turandot|Marco Balderi|Michel Plasson|Paolo Facincani,Andrea Battistoni,Armando Tasso|Richard Strauss|Rosetta Cucchi|Salome|Sessantesimo Festival Puccini, Torre del Lago|Teatro Carlo Felice di Genova|Turandot
tag|Giacomo Puccini|15
tag|Lawrence Foster|12
