DIMITRI PKHALADZE|"Il barbiere di Siviglia"|-|Alberto|Basilio|Gioacchino Rossini|Pesaro, Auditorium Pedrotti
GIORGIA PACI|"Il barbiere di Siviglia"|-|Alberto|Berta|Gioacchino Rossini|Pesaro, Auditorium Pedrotti
XUE TAO|"Il barbiere di Siviglia"|-|Alberto|Gioacchino Rossini|Pesaro, Auditorium Pedrotti|Un ufficiale
YUNPENG WANG|"Il barbiere di Siviglia"|-|Alberto|Figaro|Gioacchino Rossini|Pesaro, Auditorium Pedrotti
SALVATORE GIACALONE|"Il Trovatore"|"La Traviata"|"Rigoletto"|-|Daniele Abbado|Daniele Callegari|Diego Matheuz|Doppia inaugurazione|Fenice|Francesco Micheli|Giacomo Puccini|Giuseppe Verdi|Lorenzo Mariani|Myung-whun Chung|Reggio Emilia, Teatro Valli|Riccardo Frizza|Robert Carsen|Un araldo|Un commissionario|Un sergente dei doganieri|Un usciere di corte|Un vecchio zingaro|Venezia, Teatro La Fenice
GIOVANNI MEONI|"La Traviata"|"Madama Butterfly"|"Nabucco"|"Nabucodonosor"|"Otello"|"Rigoletto"|"Un ballo in maschera"|Andrea Battistoni|Antoine Selva|Diego Matheuz|Ferzan Ozpetek|Giacomo Puccini|Gianluca Martinenghi|Giorgio Germont|Giuseppe Verdi|Henning Brockhaus|Jago|Jean-paul Scarpitta|Josè Miguel Perez Sierra|Macerata Opera Festival|Marcello Bufalini|Massimo Gasparon|Nabucco|Napoli, Teatro di San Carlo|Nello Santi|Nicola Zorzi|Palermo|Paolo Arrivabeni|Pisa, Teatro Verdi|Renato|Renato Palumbo|Renzo Giaccheri|Riccardo Muti|Rigoletto|Robert Carsen|Roma, Teatro dell'Opera|Sessantesimo Festival Puccini, Torre del Lago|Sharpless|Teatro Massimo di Palermo|Teramo, Teatro Comunale|Venezia, Teatro La Fenice
ROBERTO JACHINI VIRGILI|"Falstaff"|"Il Trovatore"|"La Traviata" si fa fiaba|"La metamorfosi"|"Lucia di Lammermoor" al Pergolesi di Jesi|"Madama Butterfly"|-|Ascoli Piceno|Bardolfo|Fabio Ceresa|Firenze, Teatro Goldoni|Gaetano Donizetti|Gastone|Giampaolo Maria Bisanti|Giuseppe Verdi|Goro|Henning Brockhaus|Jesi, Teatro "Pergolesi"|Marco Angius|Marco Spada|Matteo Beltrami|Normanno|Ospite I|Palermo, Teatro Massimo|Paul Curran|Pier’alli|Renato Palumbo|Ricordando Svoboda|Ruiz|Silvia Colasanti|Stagione lirica sassarese
GIAMPIERO CICCINO|"Madama Butterfly"|-|Fabio Ceresa|Il Commissario imperiale|Jesi, Teatro "Pergolesi"
ZUZANA MARKOVÁ|"Alceste"|"Don Giovanni"|"Elegy for Young Lovers"|"La Cenerentola"|"Un ballo in maschera"|Bologna, Teatro Comunale|Christoph Willibald Gluck|Clorinda|Daniele Abbado|Donna Anna|Elizabeth Zimmer|Gioachino Rossini|Giuseppe Verdi|Guillaume Tourniaire|Hans Werner Henze|Il suono del silenzio|Ismene|Jonathan Webb|Malibran con "Aspern" di Salvatore Sciarrino|Malibran di Venezia|Marco Angius|Massimo Gasparon|Massimo Gasparon,Pier Luigi Pizzi|Michele Mariotti|Oscar|Paolo Arrivabeni|Pier Luigi Pizzi|Salvatore Sciarrino|Tamás Pál|Teatro Massimo di Palermo|Una cantatrice/Un’amica in viaggio|Università Iuav Di Venezia Dipartimento Ppac|Venezia, Teatro La Fenice|Wolfgang Amadeus Mozart
GIOVANNI DI DEO|"La Bohème"|Giacomo Puccini|Leo Muscato|Macerata Opera Festival|Paolo Arrivabeni|Un venditore
ANTONIO STRAGAPERDE|"La Bohème"|Benoît|Giacomo Puccini|Leo Muscato|Macerata Opera Festival|Paolo Arrivabeni
CARLO CITTADINI|"Madama Butterfly"|Dolore|Fano, Teatro della Fortuna|Francesco Ivan Ciampa|Giacomo Puccini|Pierluigi Pizzi
GIANFRANCO GRICINELLA|"Madama Butterfly"|Fano, Teatro della Fortuna|Francesco Ivan Ciampa|Giacomo Puccini|Pierluigi Pizzi|Ufficiale del registro
GIUSEPPE LAMICELA|"Il barbiere di Siviglia"|-|Alberto|Ambrogio|Gioacchino Rossini|Pesaro, Auditorium Pedrotti
LI SUXIN|"Il barbiere di Siviglia"|-|Alberto|Fiorello|Gioacchino Rossini|Pesaro, Auditorium Pedrotti
DANIEL GOLOZZOV|"Turandot"|-|Antonio Pirolli|Giacomo Puccini|Teatro Filarmonico di Verona|Timur
FRANCESCO ANILE|"Norma"|"Otello"|"Turandot"|-|Antonio Pirolli|Calaf|Daniele Rustioni|Giacomo Puccini|Gianandrea Noseda|Giuseppe Verdi|Otello|Pavia, Teatro Fraschini|Pierpaolo Pacini|Pollione|Teatro Filarmonico di Verona|Teatro Regio di Torino|Vincenzo Bellini|Walter Sutcliffe
SUNNYBOY DLADLA|"Il barbiere di Siviglia"|"Turandot"|-|Alberto|Antonio Pirolli|Giacomo Puccini|Gioacchino Rossini|Il Conte d'Almaviva|Pesaro, Auditorium Pedrotti|Principe di Persia|Teatro Filarmonico di Verona
VERONICA SENSERINI|"Rigoletto"|"Rigoletto" al Teatro Pergolesi di Jesi|-|Brescia, Teatro Grande|Giovanna|Giuseppe Verdi|Marco Guidarini|Massimo Gasparon|un grande successo
BIANCA TOGNOCCHI|"L'elisir d'amore"|"La finta semplice"|"La scala di seta"|"Rigoletto"|"Rigoletto" al Teatro Pergolesi di Jesi|-|Andrea Battistoni|Arnaud Bernard|Brescia, Teatro Grande|Como, Teatro Sociale|Damiano Michieletto|Elisabetta Courir|Fabio Luisi|Francesco Ommassini|Gaetano Donizetti|Giannetta|Gioachino Rossini|Giulia|Giuseppe Verdi|Grischa Asagaroff|Il paggio della duchessa|Marco Guidarini|Massimo Gasparon|Milano, Teatro alla Scala|Ninetta|OperaLombardia, Teatro Ponchielli di Cremona|Paggio della Duchessa|Salvatore Percacciolo|Verona, Teatro Filarmonico|Wolfgang Amadeus Mozart|un grande successo
EUGENIY STANIMIROV|"Rigoletto"|"Rigoletto" al Teatro Pergolesi di Jesi|-|Brescia, Teatro Grande|Giuseppe Verdi|Marco Guidarini|Massimo Gasparon|Sparafucile|un grande successo
MARIAN RESTE|"Rigoletto"|"Rigoletto" al Teatro Pergolesi di Jesi|-|Brescia, Teatro Grande|Giuseppe Verdi|Il Conte di Ceprano|Il conte di Ceprano|Marco Guidarini|Massimo Gasparon|un grande successo
MIRIAM ARTIACO|"La Vedova allegra"|"La vedova allegra"|"Madama Butterfly"|"Rigoletto"|Alfred Eschwé|Antonio Pirolli|Brescia, Teatro Grande|Federico Tiezzi|Franz Lehár|Giacomo Puccini|Giuseppe Verdi|Jesi, Teatro Pergolesi|Kate Pinkerton|La Contessa di Ceprano|Marco Guidarini|Massimo Gasparon|Nicola Luisotti|Olga|Pippo Delbono|Praskowia|San Carlo di Napoli|Teatro San Carlo di Napoli|Vittorio Sgarbi
IRINA DUBROVSKAIA|"Rigoletto"|Brescia, Teatro Grande|Gilda|Giuseppe Verdi|Marco Guidarini|Massimo Gasparon
IVAN INVERARDI|"Aida"|"Falstaff"|"Nabucco"|"Rigoletto"|-|Amonasro|Ancora “Nabucco”|Brescia, Teatro Grande|Franco Zeffirelli|Gaetano D´espinosa|Gianfranco De Bosio|Giuseppe Verdi|Julian Kovatchev|Leo Muscato|Marco Guidarini|Marco Spada|Massimo Gasparon|Nabucco|Rigoletto|Sassari, Teatro Comunale|Sergio Alapont|Sir John Falstaff|Stagione lirica sassarese|Teatro Comunale di Sassari|’Arena di Verona
GIACOMO MEDICI|"Don Pasquale"|"La Traviata"|"La forza del destino"|"Rigoletto"|"Tosca"|-|Alessandro Talevi|Ancona, Teatro delle Muse|Andrea De Rosa|Antonio Pirolli|Arena Sferisterio di Macerata|Barone Douphol|Beppe De Tomasi|Bruno Campanella|Daniele Callegari|Dottor Grenvil|Fano,Teatro della Fortuna|Francesco Ivan Ciampa|Gaetano Donizetti|Giacomo Puccini|Giuseppe Verdi|Henning Brockhaus|Jesi, Teatro Pergolesi|Marullo|Massimo Gasparon|Pier Luigi Pizzi|Roberto Parmeggiani|Sciarrone|Teatro della Fortuna|Un alcade|Un notaro
VANESSA GOIKOETXEA|"Gisela!"|Constantin Trinks|Emma Dante|Gisela|Hans Werner Henze|Palermo, Teatro Massimo
NOZOMI KATO|"Madama Butterfly"|Giacomo Puccini|Sandro Pasqualetto|Suzuki|Teatro Comunale di Modena|Valerio Galli
DANIELA MAZZUCATO|"La Bohème"|Donato Renzetti|Elisabetta Brusa|Giacomo Puccini|Musetta|Trieste
FEDERICO CUCINOTTA|"Il barbiere di Siviglia"|Alessio Pizzech|Fiorello|Gioachino Rossini|Nicola Paszkowski|Teatro Goldoni di Livorno
EUGENIO DI LIETO|"Il barbiere di Siviglia"|Alessio Pizzech|Don Basilio|Gioachino Rossini|Nicola Paszkowski|Teatro Goldoni di Livorno
ALFONSO ZAMBUTO|"Il barbiere di Siviglia"|Alessio Pizzech|Gioachino Rossini|Il Conte d’Almaviva|Nicola Paszkowski|Teatro Goldoni di Livorno
DIEGO SAVINI|"Il barbiere di Siviglia"|Alessio Pizzech|Don Bartolo|Gioachino Rossini|Nicola Paszkowski|Teatro Goldoni di Livorno
ANDREA GAMBUZZA|"Il barbiere di Siviglia"|Alessio Pizzech|Ambrogio|Gioachino Rossini|Nicola Paszkowski|Teatro Goldoni di Livorno
JIN HEON SONG|"Madama Butterfly"|Giacomo Puccini|Il commissario imperiale|Sandro Pasqualetto|Teatro Comunale di Modena|Valerio Galli
GIOVANNI GREGNANIN|"Madama Butterfly"|Giacomo Puccini|L’ufficiale del registro|Sandro Pasqualetto|Teatro Comunale di Modena|Valerio Galli
DANIELA BORTOLON|"Madama Butterfly"|Giacomo Puccini|La zia|Sandro Pasqualetto|Teatro Comunale di Modena|Valerio Galli
AGATA PASSERINI|"Madama Butterfly"|Dolore|Giacomo Puccini|Sandro Pasqualetto|Teatro Comunale di Modena|Valerio Galli
SERENA ALLEVI|"Madama Butterfly"|Fano, Teatro della Fortuna|Francesco Ivan Ciampa|Giacomo Puccini|La cugina|Pierluigi Pizzi
PASQUALE AMATO|"I Capuleti e i Montecchi"|"La Traviata"|"Medea"|"Rigoletto"|"Rigoletto" al Teatro Pergolesi di Jesi|-|Andrea Cigni|Antonio Pirolli|Brescia, Teatro Grande|Capo delle guardie del Re|Carmelo Rifici|Christian Capocaccia|Como, Teatro Sociale|Giuseppe La Malfa|Giuseppe Verdi|Il Conte di Monterone|Il Marchese D’Obigny|Lorenzo|Luigi Cherubini|Marco Guidarini|Massimo Gasparon|Pietro Mianiti|Sam Brown|Teatro Grande di Brescia|Vincenzo Bellini|un grande successo
MARIA LETIZIA GROSSELLI|"Medea"|"Nabucco"|Anna|Antonio Pirolli|Arena di Verona|Carmelo Rifici|Gianfranco De Bosio|Giuseppe Verdi|Julian Kovatchev|Luigi Cherubini|Seconda Ancella|Teatro Grande di Brescia
EFRAT ASHKENAZI|"La Traviata"|Annina|Giuseppe Verdi|Stefano Mazzonis Di Palafrera|Tel Aviv, Israeli Opera|Yishai Steckler
AYALA ZIMBLER|"La Traviata"|Flora Bervoix|Giuseppe Verdi|Stefano Mazzonis Di Palafrera|Tel Aviv, Israeli Opera|Yishai Steckler
ANNIKA KASCHENZ|"Boris Godunov"|"La Medium", "Gianni Schicchi"|"La Traviata"|"Lucia di Lammermoor"|"Rigoletto"|-|Alisa|Azema|Carlo Montanaro|Charles Gounod|Damiano Michieletto|Daniele Abbado|Diego Matheuz|Eimuntas Nekrosius|Eliahu Inbal|Feodor|Flora Bervoix|Gaetano Donizetti|Giacomo Puccini|Gioachino Rossini|Giovanna|Giulio Ciabatti|Giuseppe Verdi|Julian Kovatchev|La Ciesca|Luca Ronconi|Matteo Beltrami|Mrs.Nolan|Robert Carsen|Stéphano|Trieste, Teatro Verdi|Venezia, Teatro La Fenice
GIULIANO PELIZON|"La Medium", "Gianni Schicchi"|"La Traviata"|"La Vedova Allegra"|"Madama Butterfly"|"Rigoletto"|"Salome"|"Tosca"|-|Andrea Battistoni|Corrado Rovaris|Donato Renzetti|Due nazareni|Due soldati|Federico Tiezzi|Franz Lehar|Gabriele Lavia|Giacomo Puccini|Giulio Ciabatti|Giuseppe Verdi|Il commissario imperiale|Il conte di Ceprano|Il domestico di Flora|Julian Kovatchev|Matteo Beltrami|Michele Mirabella|Mr.Gobineau|Pritschitsch|Simone|Stefan Anton Reck|Stefano Trespidi|Trieste, Teatro Verdi|Un carceriere|Verona, Teatro Filarmonico
ASUYE KARAYAVUZ|"La Traviata"|Andrea Battistoni|Flora Bervoix|Giuseppe Verdi|Stefano Trespidi|Trieste, Teatro Verdi
ALESSANDRO SVAB|"Il barbiere di Siviglia"|"La Traviata"|"Macbeth"|"Salome"|"Tosca"|-|Alessio Pizzech|Andrea Battistoni|Bologna, Teatro Comunale|Cesare Angelotti|Due soldati|Gabriele Lavia|Giacomo Puccini|Gianni Marras|Gioachino Rossini|Giuseppe Verdi|Il Medico|Jader Bignamini|Joseph Franconi Lee|Marchese D'Obigny|Nicola Paszkowski|Omer Meir Wellber|Palermo, Teatro Massimo|Robert Wilson|Roberto Abbado|Stefan Anton Reck|Stefano Trespidi|Teatro Goldoni di Livorno|Teatro Valli di Reggio Emilia|Trieste, Teatro Verdi|Un ufficiale
STEFAN POP|"La Traviata"|"Roberto Devereux"|Alain Altinoglu|Alfonso Antoniozzi|Alfredo Germont|Andrea Battistoni|Carlo Rizzi|Don Ottavio|Ferzan Ozpetek|Francesco Lanzillotta|Gaetano Donizetti|Genova, Teatro Carlo Felice|Giuseppe Verdi|Henning Brockhaus|Michael Haneke|Napoli, Teatro di San Carlo|Nello Santi|Palermo, Teatro Massimo|Parigi, Opéra Bastille|Roberto Devereux, conte di Essex|Stefano Mazzonis Di Palafrera|Stefano Trespidi|Tel Aviv, Israeli Opera|Trieste, Teatro Verdi|Wolfgang Amadeus Mozart|Yishai Steckler|“Don Giovanni”
LUCIA PREMERL|"La Traviata"|Andrea Battistoni|Annina|Giuseppe Verdi|Stefano Trespidi|Trieste, Teatro Verdi
IVO FEDERICO|"Il barbiere di Siviglia"|"La Bohème"|"La Traviata"|"Rigoletto"|Andrea Battistoni|Corrado Rovaris|Donato Renzetti|Elisabetta Brusa|Giacomo Puccini|Gioachino Rossini|Giuseppe Verdi|Michele Mirabella|Ruggero Cappuccio|Sergente dei doganieri|Stefano Trespidi|Trieste|Trieste, Teatro Verdi|Un commissionario|Un ufficiale|Un usciere
IORIO ZENNARO|"Iris"|"La Traviata"|"La gazza ladra"|"Lucia di Lammermoor"|"Rigoletto"|"Turandot"|-|Andrea Battistoni|Damiano Michieletto|Daniele Abbado|Diego Matheuz|Federico Tiezzi|Firenze con Turandot|Gaetano Donizetti|Gastone|Gastone de Letorieres|Giacomo Puccini|Gianluca Martinenghi|Gilbert Deflo|Gioachino Rossini|Giovanni Battista Rigon|Giuseppe Verdi|Il cenciaiolo|Isacco|Marcello Mottadelli|Matteo Borsa|Normano|Palermo, Teatro Massimo|Palermo, Teatro di Verdura|Pang|Pietro Mascagni|Pong|Reggio Emilia, Teatro Valli|Robert Carsen|Stefano Ranzani|Stefano Trespidi|Trieste, Teatro Verdi|Venezia, Teatro La Fenice|Verona|Verona, Teatro Filarmonico|Willy Landin|Zubin Mehta|Zubin Mehta festeggia i cinquant’anni
LUCIANO LEONI|"Don Giovanni"|"I puritani"|"La Traviata"|Andrea Cigni|Antonio Pirolli|Bergamo Musica Festival|Brescia, Teatro Grande|Bruno Berger-gorski|Carmelo Rifici|Giacomo Sagripanti|Giuseppe Verdi|Il Dottor Grenvil|Jari Hämäläinen|Lord Gualtiero Valton|Masetto|Pietro Mianiti|Splendida lettura registica e vocale di "Puritani"|Teatro Pergolesi di Jesi|Vincenzo Bellini|Wolfgang Amadeus Mozart
NELLY MIRICIOIU|"Roberto Devereux"|Bruno Campanella|Elisabetta I|Francesco Bellotto|Gaetano Donizetti|Pordenone
ROBERTO DE BIASIO|"Attila"|"Gisela!"|"I Lombardi alla prima crociata"|"I due Foscari"|"Macbeth"|"Roberto Devereux"|-|Andrea Battistoni|Arvino|Bologna, Teatro Comunale|Bruno Campanella|Busseto|Constantin Trinks|Daniele Callegari|Donato Renzetti|Emma Dante|Foresto|Francesco Bellotto|Gaetano Donizetti|Gennaro Esposito|Giuseppe Verdi|Hans Werner Henze|Jacopo Foscari|Joseph Franconi Lee|Lamberto Pugelli|Macduff|Palermo, Teatro Massimo|Parma, Teatro Regio|Pierfrancesco Maestrini|Pordenone|Regio di Parma|Robert Wilson|Roberto Abbado|Roberto Devereux
SLAVKO SEKULIC|"Roberto Devereux"|Bruno Campanella|Francesco Bellotto|Gaetano Donizetti|Pordenone|Sir Gualtiero
SEON YOUNG PAK|"Roberto Devereux"|Bruno Campanella|Francesco Bellotto|Gaetano Donizetti|Pordenone|Un paggio
OLGA MARIA SALATI|"Rigoletto"|Alessandro Talevi|Fano,Teatro della Fortuna|Francesco Ivan Ciampa|Giuseppe Verdi|La contessa, sua sposa
VALENTINA CHIARI|"Rigoletto"|Alessandro Talevi|Fano,Teatro della Fortuna|Francesco Ivan Ciampa|Giuseppe Verdi|Paggio della duchessa
ALESSANDRO DE ANGELIS|"Il Corsaro"|"La Bohème"|"La Traviata"|"La battaglia di Legnano"|"Salome"|-|Andrea Battistoni|Boris Brott|Cinque giudei FEDERICO LEPRE|Donato Renzetti|Elisabetta Brusa|Gabriele Lavia|Giacomo Puccini|Gianluigi Gelmetti|Giuseppe|Giuseppe Verdi|Parpignol|Ruggero Cappuccio|Stefan Anton Reck|Stefano Trespidi|Trieste|Trieste, Teatro Verdi|Un araldo|Uno schiavo
LUCA GRANZIERA|"La Sonnambula"|-|Stefano Vizioli|Teatro Sociale di Como|Un notaro|Vincenzo Bellini
MARINA BUCCIARELLI|"Don Giovanni"|"Don Quichotte"|"La Cenerentola"|"La Sonnambula"|"La Traviata"|"Orfeo all'inferno"|-|Annina|Brescia, Teatro Grande|Clorinda|Daniel Cohen,Marco Faelli|Diego Matheuz|Elisabetta Courir|Euridice|Fanny, sua figlia|Federico Tiezzi|Firenze, Palazzo Pitti|Gabriele Ferro|Genova, Teatro Carlo Felice|Gioachino Rossini|Giorgio Barberio Corsetti|Giovanni Di Stefano|Giuseppe Verdi|Il giovane Rossini al Malibran|Isabella|Jacques Offenbach|Jules Massenet|Lisa|Marco Carniti|Massimo Lambertini|Pedro|Ricetta|Robert Carsen|Rossini in agrodolce|Stefano Montanari|Stefano Vizioli|Teatro Lirico di Cagliari|Teatro Massimo di Palermo|Teatro Sociale di Como|Venezia, Teatro La Fenice|Vincenzo Bellini|Wolfgang Amadeus Mozart|Xu Zhong|Zerlina|diciott'anni, ma non li dimostra
NADIJA PETRENKO|"La Sonnambula"|-|Stefano Vizioli|Teatro Sociale di Como|Teresa|Vincenzo Bellini
ARMANDO GABBA|"Alceste"|"Candide"|"La Traviata"|"Rigoletto"|"Tosca"|-|Barone Douphol|Carlo Felice di Genova|Christoph Willibald Gluck|Daniele Abbado|Daniele Callegari|Davide Livermore|Diego Matheuz|Francesco Ivan Ciampa|Francesco Micheli|Giacomo Puccini|Gioachino Rossini|Giuseppe Verdi|Guillaume Tourniaire|Il Sagrestano|Il giovane Rossini al Malibran|Inquisitor II, Croupier|Leonard Bernstein|Lorenzo Amato|Lorenzo Mariani|Magia|Marullo|Myung-whun Chung|Norton, cassiere di Mill|Paul Curran|Pier Luigi Pizzi|Reggio Emilia, Teatro Valli|Robert Carsen|Roma, Teatro dell'Opera|Salerno, Teatro Verdi|Schaunard|Stefano Montanari|Stefano Ranzani|Un banditore / Oracolo|Un pilota|Venezia, Teatro La Fenice|Wayne Marshall|diciott'anni, ma non li dimostra|filtro, magia di Chung
REBEKA LOKAR|"Rigoletto"|Daniele Abbado|Diego Matheuz|Giovanna|Giuseppe Verdi|Reggio Emilia, Teatro Valli
MIHAIL DOGOTARI|"La Sonnambula"|"Roméo et Juliette"|-|Alessio|Andrea Cigni|Brescia, Teatro Grande|Charles Gounod|Massimo Lambertini|Mercutio|Michael Balke|Stefano Vizioli|Teatro Sociale di Como|Vincenzo Bellini
THOMAS HALL|"Der fliegende Holländer"|"Tosca"|-|Antonio Pirolli|Cremona, Teatro Ponchielli|Der Holländer|Federico Grazzini|Giacomo Puccini|Il barone Scarpia|Jesi, Teatro Pergolesi|Massimo Gasparon|Roman Brogli-sacher
PARK TAIHWAN|"Roméo et Juliette"|Andrea Cigni|Brescia, Teatro Grande|Capulet|Charles Gounod|Michael Balke
KOR-JAN DUSSELJEE|"Der fliegende Holländer"|-|Cremona, Teatro Ponchielli|Erik|Federico Grazzini|Roman Brogli-sacher
CIRO PASSILONGO|"La Traviata"|-|Daniele Callegari|Diego Matheuz|Francesco Micheli|Giacomo Puccini|Giuseppe|Giuseppe Verdi|Parpignol|Robert Carsen|Venezia, Teatro La Fenice
COSIMO D'ADAMO|-|Daniele Callegari|Francesco Micheli|Giacomo Puccini|Un venditore ambulante
ALESSANDRO SCOTTO DI LUZIO|"Don Pasquale"|"Il Campiello"|"L'Amico Fritz"|"L'elisir d'amore"|"Lucia di Lammermoor"|"Lucia di Lammermoor" al Pergolesi di Jesi|"Rigoletto"|-|Alfredo Germont|Arnaud Bernard|Arturo|Brescia, Teatro Grande|Bucklaw|Ermanno Wolf-ferrari|Ernesto|Fabrizio Maria Carminati|Francesco Cilluffo|Francesco Lanzillotta|Fritz Kobus|Gaetano Donizetti|Giampaolo Bisanti|Giulio Ciabatti|Giuseppe Verdi|Guglielmo Ferro|Henning Brockhaus|Il duca di Mantova|Italo Nunziata|Leo Muscato|Lord Arturo Bucklaw|Lord Arturo</em> <em>Bucklaw|Lorenzo Fratini,Giuseppe La Malfa|Matteo Beltrami|Nemorino|Novara|Omer Meir Wellber|Pietro Mascagni|Ricordando Svoboda|Rosetta Cucchi|Simona Marchini|Sir Edgardo di Ravenswood|Teatro La Fenice di Venezia|Teatro del Maggio Musicale Fiorentino|Teatro dell'Opera di Firenze|Venezia, Teatro La Fenice|Verona, Teatro Filarmonico|Zorzeto|giardino di Palazzo Zuckermann di Padova|«Di ragion la trasse amore …». "Lucia di Lammermoor"
ORIANA KURTESHI|"L'elisir d'amore"|-|Bepi Morassi|Gaetano Donizetti|Giannetta|Teatro "La Fenice" di Venezia|Venezia, Teatro La Fenice
DESIREE RANCATORE|"Don Pasquale"|"L'elisir d'amore"|"Lucia di Lammermoor"|"Rigoletto"|-|Adina|Andrea Battistoni|Bepi Morassi|Daniele Abbado|Denis Polyadès|Diego Matheuz|Enrique Mazzola|Gaetano Donizetti|Gilbert Deflo|Gilda|Giuseppe Verdi|Lucia Ashton|Macerata Opera Festival|Massimo Gasparon|Norina|Palermo, Teatro Massimo|Parigi, Théâtre des Champs Elysées|Stefano Ranzani|Teatro "La Fenice" di Venezia|Venezia, Teatro La Fenice
CELSO ALBELO|"L'elisir d'amore"|"La fille du régiment"|"Pagliacci/Cavalleria rusticana"|"Rigoletto"|"Roberto Devereux"|-|Benjamin Pionnier|Bepi Morassi|Beppe/Arlecchino|Damiano Michieletto|Daniel Harding|Daniel Oren|Daniele Abbado|Diego Matheuz|Filippo Crivelli|Francesco Cilluffo|Francesco Ivan Ciampa|Gaetano Donizetti|Georges Bizet|Gioachino Rossini|Giuseppe Verdi|Graham Vick|Il Duca di Mantova|Il duca di Mantova|Lorenzo Amato|Marcello Grigorov|Mario Martone|Michele Mariotti|Milano, Teatro alla Scala|Nadir|Nemorino|Nemorino, coltivatore, giovane semplice|Opera di Firenze|Palermo, Teatro Massimo|Paolo Arrivabeni|Pietro Mascagni|Riccardo Canessa|Roberto Devereux, Conte di Essex|Ruodi, pêcheur|Salerno, Teatro Verdi|Teatro "La Fenice" di Venezia|Teatro Comunale di Modena|Teatro Massimo di Palermo|Tonio|Venezia, Teatro La Fenice
JENNIFER LARMORE|"Lulu"|"Macbeth"|"The turn of the screw"|-|Alban Berg|Bologna, Teatro Comunale|Giuseppe Verdi|Gräfin Geschwitz|Lady Macbeth|Michael Schonwandt|Miss Jessel|Parigi, Opéra Bastille|Robert Carsen|Robert Wilson|Roberto Abbado|Theater an der Wien|Willy Decker
NADIYA PETRENKO|"Der fliegende Holländer"|"Ernani"|"La Sonnambula"|"Les contes d'Hoffmann"|"Norma"|"Roméo et Juliette"|-|Andrea Cigni|Antonio Pirolli|Brescia, Teatro Grande|Charles Gounod|Christian Capocaccia|Clotilde|Cremona, Teatro Ponchielli|Daniele Rustioni|Federico Grazzini|Frédéric Roels|Gertrude|Giovanna|Giuseppe Verdi|Jacques Offenbach|La mère d'Antonia|Mary|Massimo Lambertini|Michael Balke|Pavia, Teatro Fraschini|Pierpaolo Pacini|Roman Brogli-sacher|Stefano Vizioli|Teatro Fraschini di Pavia|Teresa|Vincenzo Bellini
ALESSANDRA PALOMBA|"Andrea Chénier"|"L'Amico Fritz"|"Madama Butterfly"|"Medea"|"Norma"|"Rigoletto"|"Rigoletto" al Teatro Pergolesi di Jesi|"Roméo et Juliette"|-|Adalgisa|Andrea Battistoni|Andrea Cigni|Antonio Pirolli|Arnaud Bernard|Beppe|Brescia, Teatro Grande|Carmelo Rifici|Charles Gounod|Daniele Rustioni|Genova, Teatro Carlo Felice|Giacomo Puccini|Giampaolo Bisanti|Giuseppe Verdi|Lamberto Puggelli|Luigi Cherubini|Maddalena|Madelon|Marco Guidarini|Massimo Gasparon|Matteo Beltrami,Luca Sirigu|Neris|Pavia, Teatro Fraschini|Pierpaolo Pacini|Pietro Mascagni|Sassari, Teatro Comunale|Sergio Alapont|Stéphano|Suzuki|Teatro Carlo Felice di Genova|Teatro Comunale di Sassari|Teatro Grande di Brescia|Umberto Giordano|Vincenzo Bellini|un grande successo
RAFFAELLA LUPINACCI|"Così fan tutte"|"L'Italiana in Algeri"|"La forza del destino"|"Madama Butterfly"|"Nabucco"|"Otello"|"Tancredi"|Andrea Cigni|Como, Teatro Sociale|Curra|Davide Livermore|Dorabella, dame ferraresi e sorelle|Emilia|Fano, Teatro della Fortuna|Fenena|Francesco Cilluffo|Francesco Frongia|Francesco Ivan Ciampa|Giacomo Puccini|Giampaolo Bisanti|Gioachino Rossini|Giovanni Battista Rigon|Giuseppe Verdi|Isaura|Jader Bignamini|Josè Ramon Encinar|Lorenzo Regazzo|Marcello Mottadelli|Pavia, Teatro Fraschini|Pierluigi Pizzi|ROF|Stefano De Luca|Stefano Poda|Suzuki|Teatro Olimpico di Vicenza|Teatro Ponchielli di Cremona|Teatro Regio di Parma|Wolfang Amadeus Mozart|Zulma
HYUNN KYUNG SON|"Turandot"|-|Antonio Pirolli|Giacomo Puccini|Liù|Teatro Filarmonico di Verona
LILLA LEE|"Turandot"|-|Antonio Pirolli|Giacomo Puccini|Teatro Filarmonico di Verona|Turandot
RAFFAELE PASTORE|"La Bohème"|"La Sonnambula"|"Rigoletto"|-|Bari, Teatro Petruzzelli|Bepi Morassi|Carlo Rizzari|Daniele Callegari|Denis Krief|Francesco Micheli|Gabriele Ferro|Giacomo Puccini|Giorgio Barberio Corsetti|Giuseppe Verdi|Juraj Valcuha|Matteo Borsa|Petruzzelli di Bari|Un notaro|Un venditore ambulante|Venezia, Teatro La Fenice|Vincenzo Bellini
CARLO MATTIAZZO|"Il Trovatore"|"La Bohème"|Francesco Micheli|Giacomo Puccini|Giuseppe Verdi|Juraj Valcuha|Lorenzo Mariani|Parpignol|Riccardo Frizza|Ruiz|Venezia, Teatro La Fenice
GIANLUCA BURATTO|"Il cappello di paglia di Firenze"|"La Bohème"|"Leggenda"|"Macbeth"|"Rigoletto"|-|Alessandro Solbiati|Andrea Battistoni|Andrea Cigni|Carlo Rizzari|Colline|Daniele Abbado|Daniele Callegari|Daniele Rustioni|Davide Livermore|Diego Matheuz|Fabio Ceresa|Firenze|Francesco Micheli|Giacomo Puccini|Gianandrea Noseda|Giuseppe Verdi|Juraj Valcuha|Mario Pontiggia|Matteo Beltrami|Medico|Nino Rota|Nonancourt|Peter Stein|Pier Giorgio Morandi|Reggio Emilia, Teatro Valli|Rolando Panerai|Roma, Teatro dell'Opera|Roma,Terme di Caracalla|Savona, Complesso Monumentale del Priamar|Scienza e Belcanto all'Opera di Firenze|Sir Giorgio Valton, suo fratello|Sparafucile|Spirito del Non Essere|Stefano Poda|Teatro Massimo di Palermo|Torino, Teatro Carignano|Venezia, Teatro La Fenice|Vincenzo Bellini|“I Puritani”
NICOLA NALESSO|"La Bohème"|-|Bepi Morassi|Daniele Callegari|Francesco Micheli|Giacomo Puccini|Gioachino Rossini|Il "Barbiere" di Morassi|Juraj Valcuha|Malibran|Stefano Rabaglia|Un doganiere|Un ufficiale|Venezia, Teatro La Fenice
ALESSIO DE VECCHIS|"La Traviata" si fa fiaba|"Madama Butterfly"|Ascoli Piceno|Fano, Teatro della Fortuna|Francesco Ivan Ciampa|Giacomo Puccini|Giampaolo Maria Bisanti|Giuseppe Verdi|Henning Brockhaus|Lo zio Bonzo|Pierluigi Pizzi|Un commissionario
MURIELLE TOMAO|"La Traviata"|-|Annina|Arena Sferisterio di Macerata|Giuseppe Verdi|Henning Brockhaus
ANNALAURA PENNA*|Il suono del silenzio|Malibran con "Aspern" di Salvatore Sciarrino|Marco Angius|Salvatore Sciarrino|Titta Bordereau|Università Iuav Di Venezia Dipartimento Ppac
GAIA CERESI*|Il suono del silenzio|L’ermafrodito|Malibran con "Aspern" di Salvatore Sciarrino|Marco Angius|Salvatore Sciarrino|Università Iuav Di Venezia Dipartimento Ppac
FRANCESCO GERARDI|Il narratore|Il suono del silenzio|Malibran con "Aspern" di Salvatore Sciarrino|Marco Angius|Salvatore Sciarrino|Università Iuav Di Venezia Dipartimento Ppac
ANDREA SNARSKI|"La Bohème"|"La vedova allegra"|-|Alcindoro|Ascher Fisch|Daniele Callegari|Francesco Micheli|Franz Lehar|Giacomo Puccini|Juraj Valcuha|Milano, Teatro alla Scala|Pier Luigi Pizzi|Pritschitsch|Venezia, Teatro La Fenice
ELENA BRESCIANI|"Madama Butterfly"|-|Fabio Ceresa|Jesi, Teatro "Pergolesi"|Suzuki, servente di Butterfy
ALESSANDRO PUCCI|" Madama Butterfly "|"La Bohème"|"La Traviata"|"La vedova allegra"|"Madama Butterfly"|-|Ancona, Teatro delle Muse|Ancona, Teatro delle Muse “Franco Corelli”|Antonio Pirolli|Arena Sferisterio di Macerata|Arnaud Bernard|Fabio Ceresa|Francisco Negrin|Franz Lehár|Gabriele Bonolis|Giacomo Puccini|Giuseppe|Giuseppe Verdi|Henning Brockhaus|Jesi, Teatro "Pergolesi"|Jesi, Teatro Pergolesi|Kromow|Leo Muscato|L’ufficiale del registro|Macerata Opera Festival|Nicola Berloffa|Paolo Arrivabeni|Parpignol|Renato Palumbo|Un messo|Vittorio Sgarbi
SOFIA MCHDELISHVILI|"Lucia di Lammermoor" al Pergolesi di Jesi|Gaetano Donizetti|Henning Brockhaus|Lucia|Matteo Beltrami|Ricordando Svoboda
MIHAIL DOGOTAR|"La Traviata" si fa fiaba|Ascoli Piceno|Barone Douphol|Giampaolo Maria Bisanti|Giuseppe Verdi|Henning Brockhaus
IRINA DBROVSKAYA|"La Traviata" si fa fiaba|Ascoli Piceno|Giampaolo Maria Bisanti|Giuseppe Verdi|Henning Brockhaus|Violetta Valery
DAVIDE FILIPPONI|"Aida"|"La Traviata" si fa fiaba|"Madama Butterfly"|"Manon Lescaut"|Aldo Tarabella|Ascoli Piceno|Domestico di Flora|Fano, Teatro della Fortuna|Francesco Ivan Ciampa|Franco Zeffirelli|Giacomo Puccini|Giampaolo Maria Bisanti|Giuseppe Verdi|Henning Brockhaus|Il Re|Il commissario imperiale|Massimiliano Stefanelli|Pierluigi Pizzi|Teatro Marrucino di Chieti|Un Sergente degli Arceri / Oste
MARIANGELA MARINI|"La Traviata" si fa fiaba|"Madama Butterfly"|-|Annina|Ascoli Piceno|Fabio Ceresa|Giampaolo Maria Bisanti|Giuseppe Verdi|Henning Brockhaus|Jesi, Teatro "Pergolesi"|La madre di Cio-Cio-san
NICHOLAS GRAHAM|"Madama Butterfly"|-|Dolore|Fabio Ceresa|Jesi, Teatro "Pergolesi"
JASKO SAKO|"Madama Butterfly"|-|Fabio Ceresa|Jesi, Teatro "Pergolesi"|Madama Butterfly (Cio-cio-san)
JOOTAEK KIM|"Madama Butterfly"|-|Fabio Ceresa|Jesi, Teatro "Pergolesi"|Sharpless,Console
INNA SAVCHENKO|"Madama Butterfly"|-|Fabio Ceresa|Jesi, Teatro "Pergolesi"|La cugina
GIOVANNI PACI|"La Bohème"|Doganiere|Giacomo Puccini|Leo Muscato|Macerata Opera Festival|Paolo Arrivabeni
MARGARITA GUGLIELMI|"Madama Butterfly"|Fano, Teatro della Fortuna|Francesco Ivan Ciampa|Giacomo Puccini|La madre|Pierluigi Pizzi
DARIO SOLARI|"Attila"|"Belisario"|"Les Pecheurs de Perles"|"Macbeth"|"Maria de Rudenz"|"Pagliacci"|-|Belisario|Bergamo, Teatro Donizetti|Bologna, Teatro Comunale|Conte di Luna|Corrado Waldorf|Cristina Mazzavillani Muti|Donato Renzetti|E Cristina disse|Ezio|Fabio Sparvoli|Francesco Bellotto|Gabriele Ferro|Gaetano Donizetti|Georges Bizet|Giancarlo Cobelli|Giuseppe Verdi|Luigi Barilone|Macbeth|Marco Bellocchio|Modena, Teatro Comunale|Napoli, Teatro San Carlo|Paolo Carignani|Peter Stein|Pier Luigi Pizzi|Robert Wilson|Roberto Abbado|Roberto Tolomelli|Roma, Teatro dell'Opera|Sebastiano Rolli|Silvio|Teatro Petruzzelli di Bari|Terme di Caracalla|Zurga|“ Facciamo Trovatore… ”
SAVERIO PUGLIESE|"Ernani"|"La Traviata"|"Madama Butterfly"|"Otello"|"Rigoletto"|"Rigoletto" al Teatro Pergolesi di Jesi|"Tosca"|"Turandot"|-|Andrea Cigni|Antonio Pirolli|Borsa|Brescia, Teatro Grande|Como, Teatro Sociale|Don Riccardo|Gastone|Giacomo Puccini|Giampaolo Bisanti|Giulio Ciabatti|Giuseppe Verdi|Goro|Jesi, Teatro Pergolesi|Marco Guidarini|Massimo Gasparon|Matteo Beltrami|Matteo Borsa|Mercedes Martini|Novara, Teatro Coccia|Pang|Pietro Mianiti|Roderigo|Spoletta|Stefano De Luca|un grande successo
MIRKO QUARELLO|"La Bohme"|"La Traviata"|"Rigoletto"|"Rigoletto" al Teatro Pergolesi di Jesi|-|Alcindoro/Benot|Andrea Cigni|Brescia, Teatro Grande|Eduardo Strausser|Ferrara, Teatro Comunale|Francesco Lanzillotta|Giacomo Puccini|Giuseppe Verdi|Il Barone Douphol|Ivan Stefanutti|Marco Guidarini|Marullo|Massimo Gasparon|Padova, Teatro Verdi|Paolo Giani Cei|Pietro Mianiti|Un domestico di Flora|un grande successo
GABRIELE MANGIONE|"Der fliegende Holländer"|"L'Olandese volante"|"Macbeth"|"Mefistofele"|"Nabucco"|"Stiffelio"|"Tannhäuser"|-|Andrea Battistoni|Andrea Cigni|Arrigo Boito|Bologna, Teatro Comunale|Cremona, Teatro Ponchielli|Der Steuermann|Enrico Stinchelli|Faust|Federico Grazzini|Francesco Pasqualetti|Giuseppe Verdi|Guy Montavon|Ismaele|Lucca, Teatro del Giglio|Malcom|Marcello Bufalini|Marcello Mottadelli|Nicola Zorzi|Raffaele|Robert Wilson|Roberto Abbado|Roman Brogli-sacher|Stefan Anton Reck|Steuermann|Teatro Ponchielli di Cremona|Teatro Regio di Parma|Teramo, Teatro Comunale|Walter von der Vogelweide|Yannis Kokkos,Stephan Grögler
MARTA MORETTO|"Salome"|-|Gabriele Lavia|Herodias|Stefan Anton Reck|Trieste, Teatro Verdi
MARIANNA VINCI|"Il cappello di paglia di Firenze"|"Il furioso all'isola di San Domingo"|"La Traviata"|"Macbeth"|"Rigoletto"|-|Andrea Cigni|Bari, Teatro Petruzzelli|Bergamo, Teatro Donizetti|Bologna, Teatro Comunale|Brescia, Teatro Grande|Carlo Rizzari|Dama|Denis Krief|Elena Barbalich|Flora Bervoix|Francesco Esposito|Gaetano Donizetti|Giovanni Di Stefano|Giuseppe Verdi|La baronessa di Champigny|Maddalena|Marcella|Nino Rota|Pietro Mianiti|Robert Wilson|Roberto Abbado|Savona
MINA PAVLOVA|"La Traviata"|Andrea Cigni|Annina|Brescia, Teatro Grande|Giuseppe Verdi|Pietro Mianiti
JEAN-FRANCOIS BORRAS|"La Traviata"|"Roméo et Juliette"|"Turandot"|Alfredo Germont|Andrea Cigni|Brescia, Teatro Grande|Charles Gounod|Charles Roubaud|Chorégies d'Orange|Giacomo Puccini|Giuseppe Verdi|Michael Balke|Michel Plasson|Pietro Mianiti|Pong|Roméo
MARCO PIRETTA|"La Traviata"|Andrea Cigni|Brescia, Teatro Grande|Commissionario|Giuseppe Verdi|Pietro Mianiti
ALESSANDRO MUNDULA|"La Traviata"|"Lucia di Lammermoor"|Andrea Cigni|Brescia, Teatro Grande|Gaetano Donizetti|Giuseppe|Giuseppe Verdi|Henning Brockhaus|Matteo Beltrami|Normanno|Novara|Pietro Mianiti|«Di ragion la trasse amore …». "Lucia di Lammermoor"
DAMIANO SALERNO|"La Bohème"|"La Traviata"|"Madama Butterfly"|Andrea Cigni|Brescia, Teatro Grande|Fano, Teatro della Fortuna|Francesco Ivan Ciampa|Francesco Lanzillotta|Francesco Micheli|Giacomo Puccini|Giorgio Germont|Giulio Ciabatti|Giuseppe Verdi|Juraj Valcuha|Leo Muscato|Macerata Opera Festival|Marcello|Paolo Arrivabeni|Parma, Teatro Regio|Pierluigi Pizzi|Pietro Mianiti|Sharpless|Venezia, Teatro La Fenice
FEDERICO SACCHI|-|Gioachino Rossini|Luca Ronconi|Oroe
DAVID FERRI DURA'|"DonTrastullo"|-|Bertrando|Giambarone|Gioachino Rossini|Luca Ronconi|Mitrane|Napoli, Teatrino di Corte|Riccardo Canessa|Ricetta|Rossini in agrodolce
CARMEN TOPCIU|"L'italiana in Algeri"|-|Arsace|Brescia, Teatro Grande|Francesco Pasqualetti|Gioachino Rossini|Isabella|Luca Ronconi|Pier Luigi Pizzi
SILVIA GIANNETTO|"Rigoletto"|Andrea Battistoni|Giuseppe Verdi|Il paggio della duchessa|Macerata Opera Festival|Massimo Gasparon
ROSSELLA LOCATELLI|-|Clarina, cameriera di Fanny|Gioachino Rossini|Il giovane Rossini al Malibran|Stefano Montanari|diciott'anni, ma non li dimostra
SANDRO PUCCI|"Carmen"|"Ernani"|"La Traviata"|"Macbeth"|Alfonso Antoniozzi|Beppe De Tomasi|Bologna, Teatro Comunale|Frédéric Chaslin|Georges Bizet|Giuseppe Verdi|Il sicario|Jago|Michele Mariotti|Pietro Babina|Robert Wilson|Roberto Abbado|Roberto Polastri|Un commissionario|Uno zingaro
NINO MENNELLA|"Il Trovatore"|"Madama Butterfly"|Giacomo Puccini|Giuseppe Verdi|Il Principe Yamadori|Michał Znaniecki|Nicola Luisotti|Pippo Delbono|Teatro San Carlo di Napoli|Un messo
ANNA PENNISI|"Madama Butterfly"|Giacomo Puccini|Nicola Luisotti|Pippo Delbono|Suzuki|Teatro San Carlo di Napoli
ALESSANDRO LERRO|"Madama Butterfly"|Giacomo Puccini|Il Commissario Imperiale|Nicola Luisotti|Pippo Delbono|Teatro San Carlo di Napoli
GIUSEPPINA BENINCASA|"Madama Butterfly"|Giacomo Puccini|La Cugina|Nicola Luisotti|Pippo Delbono|Teatro San Carlo di Napoli
GIORGIO MASTANTUONO|"Madama Butterfly"|Dolore|Giacomo Puccini|Nicola Luisotti|Pippo Delbono|Teatro San Carlo di Napoli
GABRIELE GRIECO|"Madama Butterfly"|Dolore|Giacomo Puccini|Nicola Luisotti|Pippo Delbono|Teatro San Carlo di Napoli
CLORINDA VARDACI|"Madama Butterfly"|Giacomo Puccini|La Madre di Cio-Cio-San|Nicola Luisotti|Pippo Delbono|Teatro San Carlo di Napoli
DAVIDE BARTOLUCCI|"Don Pasquale"|"La Traviata" si fa fiaba|"La cenerentola"|"Pimpinone"|-|Alessandro Talevi|Alfonso Antoniozzi|Ascoli Piceno|Comunale di Bologna|D'Obigny|Dandini|Dr. Malatesta|Giampaolo Maria Bisanti|Gianni Gualdoni|Gioachino Rossini|Giovanni Battista Pergolesi|Giuseppe Verdi|Henning Brockhaus|Juliette Deschamps|Leonardo Vordoni|Nicola Procaccini|Pandolfe|Pimpinone|Speranza Scappucci|Teatro Regio di Torino|Tomaso Albinoni|galleria Pianetti di Jesi
ARIANNA BALLOTTA|"Don Pasquale"|"Medea"|-|Alfonso Antoniozzi|Antonio Pirolli|Carmelo Rifici|Comunale di Bologna|Leonardo Vordoni|Luigi Cherubini|Norina|Prima Ancella|Teatro Grande di Brescia
FRANCISCO CORUJO|"Lucia di Lammermoor"|"Otello"|"Roméo et Juliette" di Gounod|-|Arena di Verona|Bari, Teatro Petruzzelli|Bilbao|Brescia, Teatro Grande|Carlo Montanaro|Cassio, capo di squadra|Charles Gounod|Damiano Michieletto|Edgardo|Eimuntas Nekrošius|Emilio Sagi|Fabio Mastrangelo|Francesco Micheli|Gaetano Donizetti|Giuseppe Verdi|Henning Brockhaus|Keri-lynn Wilson|Lord Arturo Bucklaw|Matteo Beltrami|Novara|Sir Edgardo</em> <em>di Ravenswood|Tybald|Tybalt|«Di ragion la trasse amore …». "Lucia di Lammermoor"
VLADIMIR BRAUN|"La Traviata"|Giuseppe Verdi|Il dottor Grenvil|Stefano Mazzonis Di Palafrera|Tel Aviv, Israeli Opera|Yishai Steckler
ELENA POPOVSKAYA|" Madama Butterfly "|Ancona, Teatro delle Muse|Arnaud Bernard|Giacomo Puccini|Madama Butterfly|Renato Palumbo
ANN HALLNBERG|Bruno Maderna,Henry Purcell|Didone|Fenice|Maderna e Purcell|Saburo Teshigawara|Saburo Teshigawara,Attilio Cremonesi
KARAS|Bruno Maderna,Henry Purcell|Danzatori: Compagnia|Fenice|Maderna e Purcell|Saburo Teshigawara|Saburo Teshigawara,Attilio Cremonesi
MARIA GRAZIA LO SCHIAVO|Belinda|Bruno Maderna,Henry Purcell|Fenice|Maderna e Purcell|Saburo Teshigawara|Saburo Teshigawara,Attilio Cremonesi
IRINA DUBROVSKAYA|"La Clemenza di Tito"|"Occasione"|"Rigoletto" al Teatro Pergolesi di Jesi|-|Berenice|Elisabetta Brusa|Gianluigi Gelmetti|Gilda|Gioachino Rossini|Il bianco s'addice|Jean Louis Grinda|Massimo Gasparon|Servilia, sorella di Sesto e amante di Annio|Stefano Rabaglia|Teatro Verdi di Trieste|Wolfgang Amadeus Mozart|un grande successo
ALSESSANDRO SPINA|"Macbeth"|-|Giuseppe Verdi|Peter Stein|Roma, Teatro dell'Opera|Sicario
ANTONIO CORIANO'|"Macbeth"|-|Giuseppe Verdi|Malcolm|Peter Stein|Roma, Teatro dell'Opera
GUY MANNHEIM|"La Traviata"|Gastone|Giuseppe Verdi|Stefano Mazzonis Di Palafrera|Tel Aviv, Israeli Opera|Yishai Steckler
GEORGE PETEAN|"La Traviata"|"Un ballo in maschera"|Alex Ollé|Bruxelles, Théâtre La Monnaie|Carlo Rizzi|Giorgio Germont|Giuseppe Verdi|René Ankarström|Stefano Mazzonis Di Palafrera|Tel Aviv, Israeli Opera|Yishai Steckler
ERNESTO GEMPERLÉ*|"Alceste"|Christoph Willibald Gluck|Eumelo|Guillaume Tourniaire|Pier Luigi Pizzi|Venezia, Teatro La Fenice
ANITA TEODORO*|"Alceste"|Aspasia|Christoph Willibald Gluck|Guillaume Tourniaire|Pier Luigi Pizzi|Venezia, Teatro La Fenice
TANIA PLAISANT*|"Alceste"|Aspasia|Christoph Willibald Gluck|Guillaume Tourniaire|Pier Luigi Pizzi|Venezia, Teatro La Fenice
LUDOVICO FURLANI*|"Alceste"|Christoph Willibald Gluck|Eumelo|Guillaume Tourniaire|Pier Luigi Pizzi|Venezia, Teatro La Fenice
VALENTINA VANDELLI|"Macbeth"|Bologna, Teatro Comunale|Fleanzio|Giuseppe Verdi|Robert Wilson|Roberto Abbado
STUART PATTERSON|" Madama Butterfly "|Ancona, Teatro delle Muse|Arnaud Bernard|Giacomo Puccini|Goro|Renato Palumbo
ENKELEJDA SHKOSA|" Madama Butterfly "|"Aida"|-|Alberto Hold-garrido|Amneris|Ancona, Teatro delle Muse|Arnaud Bernard|Azucena|Francisco Negrin|Giacomo Puccini|Giuseppe Verdi|Opéra di Toulon|Paolo Arrivabeni|Paul Emile Fourny|Renato Palumbo|Suzuki
FLORENTINA SOARE|"I Capuleti e i Montecchi"|Christian Capocaccia|Como, Teatro Sociale|Romeo|Sam Brown|Vincenzo Bellini
GIAMPIERO CICINO|"Rigoletto"|-|Alessandro Talevi|Andrea Battistoni|Antonio Greco|Caterina Panti Liberovici|Ciaccone|Daniele Abbado|Fano,Teatro della Fortuna|Francesco Esposito|Francesco Ivan Ciampa|Giuseppe Verdi|Il Dancario|Il brigadiere Ciappa|Il conte di Monterone|Il marchese D’Obigny|Leonardo Leo|Lucca, Teatro del Giglio|Marco Boemi|Nino Rota|Teatro Coccia di Novara|“La Traviata”|“Napoli milionaria”
SIMONE PIAZZOLA|"Attila"|"Don Carlo"|"La Traviata"|"La Traviata" si fa fiaba|"La traviata"|"Rigoletto" al Teatro Pergolesi di Jesi|"Simon Boccanegra"|-|Andrea Battistoni|Andrea De Rosa|Arena Sferisterio di Macerata|Ascoli Piceno|Carlo Rizzi|Cristina Mazzavillani Muti|Daniele Abbado|Daniele Callegari|Daniele Rustioni|De Guiche|Escamillo|Ezio|Fabrizio Ventura|Ferzan Ozpetek|Francesco Micheli|Francisco Negrin|Giacomo Puccini|Giampaolo Maria Bisanti|Giorgio Germont|Giuseppe Verdi|Henning Brockhau|Henning Brockhaus|Hugo De Ana|Il Conte di Luna|Jago|Joseph Franconi Lee|Marcello|Marco Boemi|Massimo Gasparon|Michele Mariotti|Modena, Teatro Comunale|Myung-whun Chung|Nicola Paszkowski|Opera di Firenze|Palermo, Teatro Massimo|Paolo Arrivabeni|Pietro Rizzo|Ravenna, Teatro Alighieri|Rigoletto|Rodrigo, Marchese di Posa|Rosetta Cucchi|Simon Boccanegra|Teatro Coccia di Novara|Teatro Comunale di Bologna|Teatro San Carlo di Napoli|Venezia, Teatro La Fenice|Verona, Teatro Filarmonico|Zubin Mehta|un grande successo|“La Traviata”
VALENTINA PUCCI|"Macbeth"|"Tosca"|Bologna, Teatro Comunale|Giacomo Puccini|Gianni Marras|Giuseppe Verdi|Jader Bignamini|Pastorello|Robert Wilson|Roberto Abbado|Seconda apparizione|Teatro Valli di Reggio Emilia
GIANLUCA D'AGOSTINO|"Macbeth"|Bologna, Teatro Comunale|Duncano|Giuseppe Verdi|Robert Wilson|Roberto Abbado
ANNALISA TAFFETANI|"Macbeth"|Bologna, Teatro Comunale|Giuseppe Verdi|Robert Wilson|Roberto Abbado|Terza apparizione
EMANUELA CONTI|"Il diario di uno scomparso" e "La voix humaine"|"Rigoletto"|Daniele Abbado|Diego Matheuz|Francesco Lanzillotta|Gianmaria Aliverta|Giuseppe Verdi|Leoš Janáček,Francis Poulenc|Tre voci femminili|Un paggio della duchessa|Venezia, Teatro La Fenice|Venezia, Teatro Malibran
LUCIANO BATINIC|"Rigoletto"|Daniele Abbado|Diego Matheuz|Giuseppe Verdi|Il conte</em> <em>di Monterone|Venezia, Teatro La Fenice
ANTONIO CORSANO|"La Traviata"|Diego Matheuz|Giuseppe Verdi|Robert Carsen|Un domestico di Flora|Venezia, Teatro La Fenice
CINZIA FORTE|"Il furioso all'isola di San Domingo"|"Il turco in Italia"|"L'elisir d'amore"|"La Traviata"|"Le nozze di Figaro"|"Madama Butterfly"|-|Adina|Arnaud Bernard|Bergamo, Teatro Donizetti|Donna Fiorilla|Eleonora|Federico Bertolani|Francesco Esposito|Francesco Ommassini|Gaetano Donizetti|Giacomo Puccini|Gioachino Rossini|Giovanni Di Stefano|Giuseppe Verdi|Luciano Acocella|Madama Butterfly (Cio-Cio-San)|Matteo Beltrami,Luca Sirigu|Michele Mariotti|Riccardo Canessa|Stefano Mazzonis Di Palafrera|Susanna|Teatro Comunale di Bologna|Teatro Comunale di Ferrara|Teatro Comunale di Sassari|Teatro Filarmonico di Verona|Tel Aviv, Israeli Opera|Violetta Valéry|Wolfgang Amadeus Mozart|Yishai Steckler
ANDREA PISTOLESI|"La Traviata"|"Macbeth"|-|Arena Sferisterio di Macerata|Domestico di Macbeth, Un Sicario, Un Araldo|Giampaolo Maria Bisanti|Giuseppe Verdi|Henning Brockhaus|Jesi, Teatro Pergolesi|Marchese d’Obigny
ROBERTO GATTEI|"La Bohème"|"La Traviata"|"Rigoletto"|-|Alessandro Talevi|Ancona, Teatro delle Muse|Ancona, Teatro delle Muse “Franco Corelli”|Apostolo Gazella|Arena Sferisterio di Macerata|Fano,Teatro della Fortuna|Francesco Ivan Ciampa|Gabriele Bonolis|Giacomo Puccini|Giuseppe Verdi|Henning Brockhaus|Il conte di Ceprano|Leo Muscato|Macerata Opera Festival|Marco Guidarini|Nicola Berloffa|Paolo Arrivabeni|Sergente dei doganieri|Un commissionario|una "Lucrezia Borgia" di successo
GIANNI PACI|" Madama Butterfly "|"La Bohème"|"La Traviata"|"Rigoletto"|"Tosca"|-|Alessandro Talevi|Ancona, Teatro delle Muse|Ancona, Teatro delle Muse “Franco Corelli”|Antonio Pirolli|Arena Sferisterio di Macerata|Arnaud Bernard|Ascanio Petrucci, un coppiere|Fano,Teatro della Fortuna|Francesco Ivan Ciampa|Gabriele Bonolis|Giacomo Puccini|Giuseppe Verdi|Henning Brockhaus|Il commissario imperiale|Il domestico di Flora|Jesi, Teatro Pergolesi|Marco Guidarini|Massimo Gasparon|Nicola Berloffa|Renato Palumbo|Un Carceriere|Un doganiere|Un usciere di Corte|una "Lucrezia Borgia" di successo
CARLO GIACCHETTA|-|Ancona, Teatro delle Muse|Marco Guidarini|Oloferno Vitellozzo|una "Lucrezia Borgia" di successo
LOREDANA PELLIZZARI|"Rigoletto"|Corrado Rovaris|Giuseppe Verdi|Il paggio della duchessa|Michele Mirabella|Trieste, Teatro Verdi
ANNIKA KASHENZ|"Rigoletto"|Corrado Rovaris|Giovanna|Giuseppe Verdi|Michele Mirabella|Trieste, Teatro Verdi
SERBAN VASILE|"Lucia di Lammermoor"|Brescia, Teatro Grande|Enrico|Gaetano Donizetti|Henning Brockhaus|Lord Enrico Ashton|Matteo Beltrami|Novara|«Di ragion la trasse amore …». "Lucia di Lammermoor"
CINZIA CHIARINI|"Lucia di Lammermoor"|"Lucia di Lammermoor" al Pergolesi di Jesi|Alisa|Brescia, Teatro Grande|Gaetano Donizetti|Henning Brockhaus|Matteo Beltrami|Novara|Ricordando Svoboda|«Di ragion la trasse amore …». "Lucia di Lammermoor"
GIOVANNI BATTISTA PARODI|"Attila"|"Falstaff"|"Il Trovatore"|"L'Orfeo" di Monteverdi|"Lucia di Lammermoor"|"Lucia di Lammermoor" al Pergolesi di Jesi|"Luisa Miller"|"Tosca"|-|Andrea Battistoni|Attila|Brescia, Teatro Grande|Bruno Bartoletti|Busseto|Carlo Felice di Genova|Cesare Angelotti|Claudio Monteverdi|Daniele Gatti|Dario Argento|Davide Livermore|Dmitri Jurowski|Ferrando|Gaetano Donizetti|Genova, Teatro Carlo Felice|Giacomo Puccini|Giampaolo Bisanti|Giuseppe Verdi|Henning Brockhaus|Hindemith e Ravel aprono la stagione lirica|Leo Nucci|L’infermiere|Matteo Beltrami|Maurice Ravel,Paul Hindemith|Novara|Palermo, Teatro Massimo|Paul Curran|Pierfrancesco Maestrini|Pistola|Plutone|Raimondo|Raimondo Bidebant|Raimondo Bidebent|Renato Palumbo|Ricordando Svoboda|Rinaldo Alessandrini|Robert Carsen|Robert Wilson|Scala|Stefano Ranzani|Teatro Delle Muse di Ancona|Teatro alla Scala di Milano|Wurm|«Di ragion la trasse amore …». "Lucia di Lammermoor"
MANUELA CUCUCCIO|"Il cappello di paglia di Firenze"|-|Anaide|Elena Barbalich|Nino Rota|Savona
SILVIA GIANNETTI|"Il cappello di paglia di Firenze"|-|Elena Barbalich|La modista|Nino Rota|Savona
ANNAMARIA SARRA|"Il cappello di paglia di Firenze"|-|Elena|Elena Barbalich|Nino Rota|Savona
KSENIA TITOVČENKO|"Don Pasquale"|Bologna, Teatro Comunale|Gaetano Donizetti|Gianni Marras|Giuseppe La Malfa|Norina
DONG HUY KIM|"Don Pasquale"|Bologna, Teatro Comunale|Don Pasquale|Gaetano Donizetti|Gianni Marras|Giuseppe La Malfa
DANIELE PALUMBO|"Don Pasquale"|Bologna, Teatro Comunale|Gaetano Donizetti|Gianni Marras|Giuseppe La Malfa|Mimo
ALESSIO VERNA|"Don Pasquale"|"Madama Butterfly"|"Rigoletto"|Arnaud Bernard|Bologna, Teatro Comunale|Dottor Malatesta|Fabrizio Maria Carminati|Gaetano Donizetti|Giacomo Puccini|Gianni Marras|Giuseppe La Malfa|Giuseppe Verdi|Il conte di Monterone|Il principe Yamadori/Yakusidé|Sandro Pasqualetto|Teatro Comunale di Modena|Valerio Galli|Verona, Teatro Filarmonico
FEDERICA GATTA|"La vedova allegra"|"Madama Butterfly"|-|Andrea Sanguineti|Giacomo Puccini|Kate Pinkerton/La madre di Cio Cio San|Nicola Berloffa|Piacenza, Teatro Municipale|Sandro Pasqualetto|Sylviane|Teatro Comunale di Modena|Valerio Galli
ELISABETTA MARTORANA|"L'Enfant Prodigue" e "Cavalleria Rusticana"|"La Traviata"|"Otello" con finalino edificante|"Šárka", "Cavalleria Rusticana"|-|Ancona, Teatro delle Muse|Antonello Manacorda|Arena Sferisterio di Macerata|Arnaud Bernard|Bruno Bartoletti|Carla Delfrate|Cortile di Palazzo Ducale|Doppia inaugurazione|Emilia|Ermanno Olmi|Fenice|Flora Bervoix|Francesco Micheli|Giuseppe Verdi|Henning Brockhaus|Lia|Lola|Marcellina|Myung-whun Chung|Pietro Mascagni|Pietro Mascagni,Claude Debussy|Venezia, Teatro La Fenice
NICHOLAS ANTHONY|"La scala di seta"|Damiano Michieletto|Figurante|Francesco Ommassini|Gioachino Rossini|OperaLombardia, Teatro Ponchielli di Cremona
LUCA VISANI|"La Traviata"|"Macbeth"|"Matilde di Shabran"|"Un Ballo in Maschera"|Alfonso Antoniozzi|Bologna, Teatro Comunale|Damiano Michieletto|Gioachino Rossini|Giuseppe|Giuseppe Verdi|L'araldo|Mario Martone|Michele Mariotti|Robert Wilson|Roberto Abbado|Rodrigo|Rossini Opera Festival|Un servo di Amelia
MARIO BELLANOVA|"La Medium", "Gianni Schicchi"|"Uno sguardo dal ponte"|David Levi|First Immigration Officer|Frank Galati|Giacomo Puccini|Giulio Ciabatti|Guccio|Matteo Beltrami|Roma, Teatro dell'Opera|Trieste, Teatro Verdi|William Bolcom
CAMILLA NERVI*|Giuliana Bordereau|Il suono del silenzio|Malibran con "Aspern" di Salvatore Sciarrino|Marco Angius|Salvatore Sciarrino|Università Iuav Di Venezia Dipartimento Ppac
ERIC CUTLER|"Daphne"|"Moise et Pharaon"|"Rigoletto"|Aménophis|Apollo|Bruxelles, Théâtre  La Monnaie|Daniele Abbado|Diego Matheuz|Gioachino Rossini|Giuseppe Verdi|Guy Joostens|Il duca di Mantova|Lothar Koenigs|Pier’alli|Reggio Emilia, Teatro Valli|Riccardo Muti|Richard Strauss|Teatro dell'Opera di Roma
MANUELA KRISCAK|"La Medium", "Gianni Schicchi"|Giacomo Puccini|Giulio Ciabatti|Matteo Beltrami|Monica|Trieste, Teatro Verdi
OSMAN SPANGHER|"La Medium", "Gianni Schicchi"|Gherardino|Giacomo Puccini|Giulio Ciabatti|Matteo Beltrami|Trieste, Teatro Verdi
SIMONE ALBERTI|"Il cappello di paglia di Firenze"|"La Medium", "Gianni Schicchi"|"Orfeo all'inferno"|-|Elena Barbalich|Emilio|Firenze, Palazzo Pitti|Giacomo Puccini|Giulio Ciabatti|Jacques Offenbach|Marco Carniti|Marte|Matteo Beltrami|Nino Rota|Pinellino|Savona|Trieste, Teatro Verdi|Xu Zhong
TIZIANA FABBRICINI|"La Medium", "Gianni Schicchi"|Giacomo Puccini|Giulio Ciabatti|Madame Flora|Matteo Beltrami|Trieste, Teatro Verdi
MARCO GASPARI|"Don Carlo"|"La Traviata"|Fabrizio Ventura|Giuseppe|Giuseppe Verdi|Joseph Franconi Lee|Modena, Teatro Comunale|Pietro Rizzo|Rosetta Cucchi|Un araldo reale
ROMINA CASUCCI|"Lucia di Lammermoor"|"Nabucco"|"Orfeo all'inferno"|Anna|Brescia, Teatro Grande|Diana|Firenze, Palazzo Pitti|Gaetano Donizetti|Giuseppe Verdi|Henning Brockhaus|Jacques Offenbach|Lucia|Marcello Bufalini|Marco Carniti|Matteo Beltrami|Nicola Zorzi|Teramo, Teatro Comunale|Xu Zhong
MATTEO MARIA FERRETTI|"Nabucco"|Giuseppe Verdi|Il Gran Sacerdote di Belo|Marcello Bufalini|Nicola Zorzi|Teramo, Teatro Comunale
CARLO ASSOGNA|"Nabucco"|Abdallo|Giuseppe Verdi|Marcello Bufalini|Nicola Zorzi|Teramo, Teatro Comunale
JESSICA NUCCIO|"L'elisir d'amore"|"La Bohème"|"La Traviata"|"La cena delle beffe"|"L’elisir d’amore"|-|Adina|Adina, ricca e capricciosa fittaiuola|Arena Sferisterio di Macerata|Carlo Rizzi|Elio Boncompagni|Fabio Sparvoli|Francesco Cilluffo|Gaetano Donizetti|Giacomo Puccini|Giampaolo Bisanti|Gianluigi Gelmetti|Giuseppe Verdi|Henning Brockhaus|Lisabetta|Lucca, Teatro del Giglio|Marcello Grigorov|Marco Boemi|Marco Gandini|Mario Martone|Milano, Teatro alla Scala|Mimì|Teatro Comunale di Modena|Teatro Verdi di Trieste|Torino|Umberto Giordano|Verona, Teatro Filarmonico|Violetta Valery
ALEXEJ YAKIMOV|"La Sonnambula"|-|Brescia, Teatro Grande|Conte Rodolfo|Il Conte Rodolfo|Massimo Lambertini|Stefano Vizioli|Teatro Sociale di Como|Vincenzo Bellini
DANILO PALMIERI|"Death in Venice"|Benjamin Britten|Bruno Bartoletti|Jaschiu|Pier Luigi Pizzi|Venezia, Teatro La Fenice
ALESSANDRO RIGA|"Death in Venice"|Benjamin Britten|Bruno Bartoletti|Pier Luigi Pizzi|Tadzio|Venezia, Teatro La Fenice
MASSIMILIANO LUCIANI|"La Traviata"|"La Traviata" si fa fiaba|-|Ancona, Teatro delle Muse|Ascoli Piceno|Carlo Montanaro|Giampaolo Maria Bisanti|Giuseppe|Giuseppe Verdi|Henning Brockhaus|Jeppo Liverotto, un usciere|Liliana Cavani|Marco Guidarini|Teatro alla Scala|una "Lucrezia Borgia" di successo
WILLIAM HERNANDEZ|"Il barbiere di Siviglia"|Alessio Pizzech|Figaro|Gioachino Rossini|Nicola Paszkowski|Teatro Goldoni di Livorno
SIMONA MARZILLI|"Il barbiere di Siviglia"|Alessio Pizzech|Berta|Gioachino Rossini|Nicola Paszkowski|Teatro Goldoni di Livorno
LAURA VERRECCHIA|"Il barbiere di Siviglia"|"La scala di seta"|"Mirandolina" di Bohuslav Martinů|-|Alessio Pizzech|Damiano Michieletto|Deianira, comica|Francesco Ommassini|Gianmaria Aliverta|Gioachino Rossini|John Axelrod|Lucilla|Nicola Paszkowski|OperaLombardia, Teatro Ponchielli di Cremona|Rosina|Teatro Goldoni di Livorno|Venezia, Teatro La fenice
CECILIA MOLINARI|"Il barbiere di Siviglia"|"Il turco in Italia"|-|Alberto|Federico Bertolani|Francesco Ommassini|Gioacchino Rossini|Gioachino Rossini|Pesaro, Auditorium Pedrotti|Rosina|Teatro Comunale di Ferrara|Zaida
RADU PINTILIE|Andrea Battistoni|Daniele Abbado|Giuseppe Verdi|Il dottor Grenvil|Teatro Coccia di Novara|“La Traviata”
STEFANO TANZILLO|Andrea Battistoni|Daniele Abbado|Gastone|Giuseppe Verdi|Teatro Coccia di Novara|“La Traviata”
MAURO PORZIO|Andrea Battistoni|Daniele Abbado|Giuseppe Verdi|Teatro Coccia di Novara|Un commissionario|“La Traviata”
PAOLO TOSCANI|Andrea Battistoni|Daniele Abbado|Giuseppe|Giuseppe Verdi|Teatro Coccia di Novara|“La Traviata”
AURELIA FLORIAN|"Otello"|Andrea Battistoni|Daniele Abbado|Daniele Callegari|Desdemona|Giuseppe Verdi|Pier Luigi Pizzi|Teatro Coccia di Novara|Teatro Regio di Parma|Violetta Valéry|“La Traviata”
FEDERICO DE ANTONI|Andrea Battistoni|Daniele Abbado|Giuseppe Verdi|Teatro Coccia di Novara|Un domestico di Flora|“La Traviata”
ANATOLY KRASIK|"La Traviata"|Giuseppe Verdi|Stefano Mazzonis Di Palafrera|Tel Aviv, Israeli Opera|Un commissionario|Yishai Steckler
LIESBETH DEVOS|"Death in Venice"|Benjamin Britten|Bruno Bartoletti|La merlettaia/suonatrice ambulante|Pier Luigi Pizzi|Venezia, Teatro La Fenice
JON SARRIS|"La Traviata"|Beppe De Tomasi|Domestico di Flora|Giuseppe Verdi|Roberto Parmeggiani|Teatro della Fortuna
JULIJA SAMSONOVA|"La Traviata"|Annina|Beppe De Tomasi|Giuseppe Verdi|Roberto Parmeggiani|Teatro della Fortuna
GILBERTO MALURGIA|"La Traviata"|Beppe De Tomasi|Gastone de Letorieres|Giuseppe Verdi|Roberto Parmeggiani|Teatro della Fortuna
IGNAZIO PUCCI|"La Traviata"|Beppe De Tomasi|Giuseppe Verdi|Roberto Parmeggiani|Teatro della Fortuna|Un commissionario
MASSIMO SALUCCI|"La Traviata"|Beppe De Tomasi|Giuseppe|Giuseppe Verdi|Roberto Parmeggiani|Teatro della Fortuna
ROBERTO GENTILI|"La Traviata"|Beppe De Tomasi|Giuseppe Verdi|Marchese d'Obigny|Roberto Parmeggiani|Teatro della Fortuna
PATRICK SIMPER|"Der fliegende Holländer"|-|Cremona, Teatro Ponchielli|Daland|Federico Grazzini|Roman Brogli-sacher
ROMANO DALZOVO|"Roméo et Juliette"|Andrea Cigni|Brescia, Teatro Grande|Charles Gounod|Gregorio|Michael Balke
JOSÉ GABRIEL MORERA|"Il barbiere di Siviglia"|Alessio Pizzech|Gioachino Rossini|Nicola Paszkowski|Notaio|Teatro Goldoni di Livorno
ALLA POZNIAK|"Don Carlo"|Fabrizio Ventura|Giuseppe Verdi|Joseph Franconi Lee|La Principessa Eboli|Modena, Teatro Comunale
IRÈNE CANDELIER|"Don Carlo"|Fabrizio Ventura|Giuseppe Verdi|Joseph Franconi Lee|Modena, Teatro Comunale|Tebaldo, paggio d'Elisabetta|Una voce dal cielo
NOAH BRIGER|"La Traviata"|Giuseppe Verdi|Il barone Douphol|Stefano Mazzonis Di Palafrera|Tel Aviv, Israeli Opera|Yishai Steckler
MICHELE CASTAGNARO|"Il Trovatore"|"Macbeth"|"Tosca"|Bologna, Teatro Comunale|Carceriere|Giacomo Puccini|Gianni Marras|Giuseppe Verdi|Jader Bignamini|Paul Curran|Prima apparizione|Renato Palumbo|Robert Wilson|Roberto Abbado|Teatro Valli di Reggio Emilia|Un domestico di Macbeth|Un vecchio zingaro
GILBERTO MULARGIA|"Norma"|"Rigoletto"|-|Alessandro Talevi|Fano,Teatro della Fortuna|Flavio|Francesco Ivan Ciampa|Giuseppe Verdi|Julian Kovatchev|Matteo Borsa|Stephen Medcalf|Teatro Lirico di Cagliari
EVGENIYA RAKOVA|"La Traviata"|Beppe De Tomasi|Flora Bervoix|Giuseppe Verdi|Roberto Parmeggiani|Teatro della Fortuna
DANIELE GIROMETTI|"La Traviata"|Beppe De Tomasi|Dr.Grenvil|Giuseppe Verdi|Roberto Parmeggiani|Teatro della Fortuna
FRANCESCO PICCOLI|"La Medium", "Gianni Schicchi"|"Lucia di Lammermoor"|"Nabucco"|Abdallo|Daniele Abbado|Festival Verdi 2008|Gaetano Donizetti|Gherardo|Giacomo Puccini|Giulio Ciabatti|Giuseppe Verdi|Julian Kovatchev|Matteo Beltrami|Michele Mariotti|Normano|Trieste, Teatro Verdi
DANIELA INNAMORATI|"La Traviata" si fa fiaba|"Luisa Miller"|"Nabucco"|"Rigoletto"|Andrea Battistoni|Ascoli Piceno|Daniele Abbado|Diego Matheuz|Federica|Fenena|Festival Verdi 2008|Flora Bervoix|Genova, Teatro Carlo Felice|Giampaolo Bisanti|Giampaolo Maria Bisanti|Giuseppe Verdi|Henning Brockhaus|Leo Nucci|Maddalena|Michele Mariotti|Reggio Emilia, Teatro Valli|Stefano Poda|Teatro Coccia di Novara|Verdi di Padova|“La Traviata”
LUCIANO MONTANARO|"Don Carlo"|"Don Giovanni"|"Nabucco"|-|Bergamo Musica Festival|Bruno Berger-gorski|Commendatore|Daniele Abbado|Fabrizio Ventura|Ferrando|Festival Verdi 2008|Francisco Negrin|Giuseppe Verdi|Gran Sacerdote|Il Grande Inquisitore|Jari Hämäläinen|Joseph Franconi Lee|Michele Mariotti|Modena, Teatro Comunale|Paolo Arrivabeni|Wolfgang Amadeus Mozart
JEAN PEZZALI|"L'elisir d'amore"|Attore|Fabio Luisi|Gaetano Donizetti|Grischa Asagaroff|Milano, Teatro alla Scala
RAZEK FRANCOIS BITAR|"Death in Venice"|Benjamin Britten|Bruno Bartoletti|La voce di Apollo|Pier Luigi Pizzi|Venezia, Teatro La Fenice
SABRINA VIANELLO|"Death in Venice"|Benjamin Britten|Bruno Bartoletti|Bruno Maderna,Henry Purcell|Fenice|Maderna e Purcell|Pier Luigi Pizzi|Prima strega|Saburo Teshigawara|Saburo Teshigawara,Attilio Cremonesi|Venditrice di fragole/giornalaia|Venezia, Teatro La Fenice
MARLIN MILLER|"Alceste"|"Death in Venice"|"Don Giovanni"|"Lulu"|"Uno sguardo dal ponte"|-|Admeto|Alban Berg|Benjamin Britten|Bruno Bartoletti|Bruno Maderna,Henry Purcell|Christoph Willibald Gluck|Damiano Michieletto,Luca Scarzella|David Levi|Der Neger|Don Ottavio|Enea|Fenice|Frank Galati|Guillaume Tourniaire|Gustav von Aschenbach|Maderna e Purcell|Michael Schonwandt|Parigi, Opéra Bastille|Pier Luigi Pizzi|Rodolpho|Roma, Teatro dell'Opera|Saburo Teshigawara|Saburo Teshigawara,Attilio Cremonesi|Teatro La Fenice|Venezia, Teatro La Fenice|William Bolcom|Willy Decker|Wolfgang Amadeus Mozart
MARK SHEIMER|"La Traviata"|Giuseppe|Giuseppe Verdi|Stefano Mazzonis Di Palafrera|Tel Aviv, Israeli Opera|Yishai Steckler
SORIN SEMIALIAN|"La Traviata"|Giuseppe Verdi|Stefano Mazzonis Di Palafrera|Tel Aviv, Israeli Opera|Un domestico di Flora|Yishai Steckler
YAIR GOREN|"La Traviata"|Giuseppe Verdi|Il marchese D’Obigny|Stefano Mazzonis Di Palafrera|Tel Aviv, Israeli Opera|Yishai Steckler
FRANCESCO PACCORINI|"Salome"|-|Due nazareni|Gabriele Lavia|Stefan Anton Reck|Trieste, Teatro Verdi
ELENA TRAVERSI|"Andrea Chénier"|"Anna Bolena"|"Evgenij Onegin"|"Lucia di Lammermoor"|"Rigoletto"|"Roméo et Juliette"|"Roméo et Juliette" di Gounod|"Salome"|-|Alisa|Alisa, damigella di Lucia|Arena di Verona|Aziz Shokhakimov|Bologna, Teatro Comunale|Boris Brott|Bruno Maderna,Henry Purcell|Charles Gounod|Daniele Abbado|Diego Matheuz|Fabio Luisi|Fabio Mastrangelo|Fenice|Francesco Micheli|Gabriele Lavia|Gaetano Donizetti|Genova, Teatro Carlo Felice|Gertrude|Giampaolo Bisanti|Giuseppe Verdi|Henning Borckhaus|Henning Brockhaus,Valentina Escobar|Jean-louis Grinda|La Contessa di Coigny|La contessa di Ceprano|La vedova Larina|Lamberto Puggelli|Maderna e Purcell|Mariusz Treliński|Parma, Teatro Regio|Piacenza, Teatro Municipale|Pëtr Il’ič Čajkovskij|Reggio Emilia, Teatro Valli|Saburo Teshigawara|Saburo Teshigawara,Attilio Cremonesi|Seconda strega|Smeton|Stefan Anton Reck|Stefano Ranzani|Trieste, Teatro Verdi|Umberto Giordano|Un paggio di Herodias|Venezia, Teatro La Fenice
JULIANNE YOUNG|Bruno Maderna,Henry Purcell|Fenice|La maga|Maderna e Purcell|Saburo Teshigawara|Saburo Teshigawara,Attilio Cremonesi
ANTHONY MICHAELS-MOORE|"Nabucco"|Daniele Abbado|Festival Verdi 2008|Giuseppe Verdi|Michele Mariotti|Nabucco
ASSUNTA SARTORI|"Nabucco"|Anna|Daniele Abbado|Festival Verdi 2008|Giuseppe Verdi|Michele Mariotti
ALIONA STARICOVA|" Madama Butterfly "|"L'Enfant Prodigue" e "Cavalleria Rusticana"|"Madama Butterfly"|Ancona, Teatro delle Muse|Arnaud Bernard|Carla Delfrate|Fano, Teatro della Fortuna|Francesco Ivan Ciampa|Giacomo Puccini|Kate Pinkerton|Lola|Pierluigi Pizzi|Pietro Mascagni,Claude Debussy|Renato Palumbo
ANTONIO CASAGRANDE|"La Bohème"|"Otello" con finalino edificante|"Rigoletto"|-|Cortile di Palazzo Ducale|Daniele Abbado|Diego Matheuz|Francesco Micheli|Giacomo Puccini|Giuseppe Verdi|Juraj Valcuha|Myung-whun Chung|Un araldo|Un sergente dei doganieri|Un usciere di corte|Venezia, Teatro La Fenice
CARLOS NATALE|"Il ratto dal serraglio"|"La Medium", "Gianni Schicchi"|"Turandot"|-|Antonio Pirolli|Giacomo Puccini|Giovanni Battista Rigon|Giulio Ciabatti|Matteo Beltrami|Pedrillo|Pong|Rinuccio|Teatro Filarmonico di Verona|Trieste, Teatro Verdi|Vicenza, Teatro Olimpico|Wolfgang Amadeus Mozart
BAYEMPINI NGQUNGWANA|"Turandot"|-|Antonio Pirolli|Giacomo Puccini|Ping|Teatro Filarmonico di Verona
ALBERTO ROTA|"Rigoletto"|Andrea Battistoni|Arena di Verona 2008|Conte di Monterone|Daniele Abbado|Diego Matheuz|Giuseppe Verdi|Il Conte di Monterone, Sparafucile|Il conte</em> <em>di Monterone|Ivo Guerra|Macerata Opera Festival|Massimo Gasparon|Reggio Emilia, Teatro Valli|Renato Palumbo
VINCENZO COSTANZO|"Macbeth"|"Madama Butterfly"|-|Alfredo Germont|Andrea Battistoni|B.F. Pinkerton|Daniele Abbado|F.B. Pinkerton|Fabio Ceresa|Fano, Teatro della Fortuna|Francesco Ivan Ciampa|Genova, Teatro Carlo Felice|Giacomo Puccini|Giampaolo Bisanti|Giuseppe Verdi|Henning Brockhaus|James Conlon|Madrid, Teatro Real|Malcolm|Nicola Luisotti|Opera di Firenze|Pierluigi Pizzi|Pinkerton|Pippo Delbono|Rodolfo|Sandro Pasqualetto|Teatro Coccia di Novara|Teatro Comunale di Modena|Teatro San Carlo di Napoli|Valerio Galli|“La Traviata”|“Luisa Miller”
ALESSANDRO BATTIATO|"Carmen"|"La Bohème"|"La Medium", "Gianni Schicchi"|"La Traviata"|"Un ballo in maschera"|-|Arena Sferisterio di Macerata|Bari, Teatro Petruzzelli|Barone Douphol|Daniele Callegari|Dominique Trottein|Ferzan Ozpetek|Francesco Micheli|Georges Bizet|Giacomo Puccini|Giulio Ciabatti|Giuseppe Verdi|Henning Brockhaus|Il dancairo|Il marchese d'Obigny|Juraj Valcuha|Le Dancaïre|Lorin Maazel|Macerata Opera Festival|Matteo Beltrami|Michele Mariotti|Pier Luigi Pizzi|Schaunard|Serena Sinigaglia|Sferisterio Opera Festival|Silvano|Spinelloccio / Ser Amantio|Teatro San Carlo di Napoli|Trieste, Teatro Verdi|Venezia, Teatro La Fenice|William Kerley|”Carmen”
JEAN FRANCOIS BORRAS|"La Bohème"|"Lucia di Lammermoor"|Donato Renzetti|Edgardo di Ravenswood|Elisabetta Brusa|Gaetano Donizetti|Giacomo Puccini|Giulio Ciabatti|Julian Kovatchev|Rodolfo|Trieste|Trieste, Teatro Verdi
THOMAS GAZHELI|"Salome"|"Siegfried"|-|Gabriele Lavia|Graham Vick|Jochanaan|Stefan Anton Reck|Teatro Massimo di Palermo|Trieste, Teatro Verdi|Wanderer (Wotan)
INGELA BRIMBERG|"Salome"|-|Gabriele Lavia|Salome|Stefan Anton Reck|Trieste, Teatro Verdi
DAX VELENICH|"La Bohème"|"La Traviata"|"Salome"|-|Donato Renzetti|Elisabetta Brusa|Gabriele Lavia|Giacomo Puccini|Gianluigi Gelmetti|Giuseppe|Giuseppe Verdi|Henning Brockhaus|Stefan Anton Reck|Teatro Verdi di Trieste|Trieste|Trieste, Teatro Verdi|Uno schiavo|Venditore ambulante
ANNA MALVASIO|"Rigoletto"|Daniele Abbado|Diego Matheuz|Giuseppe Verdi|Reggio Emilia, Teatro Valli|Un paggio della duchessa
tag|Giuseppe Verdi|133
tag|Giacomo Puccini|80
tag|"La Traviata"|59
tag|"Rigoletto"|44
tag|"Madama Butterfly"|39
tag|Venezia, Teatro La Fenice|36
tag|Gaetano Donizetti|33
tag|Henning Brockhaus|31
tag|Gioachino Rossini|31
tag|Brescia, Teatro Grande|31
tag|Daniele Abbado|30
tag|Andrea Battistoni|28
tag|Trieste, Teatro Verdi|26
tag|Massimo Gasparon|21
tag|Matteo Beltrami|21
tag|"La Bohème"|20
tag|Diego Matheuz|20
tag|Antonio Pirolli|19
tag|"Il barbiere di Siviglia"|19
tag|Bologna, Teatro Comunale|19
tag|Francesco Ivan Ciampa|19
tag|"Macbeth"|18
tag|Andrea Cigni|18
tag|Pier Luigi Pizzi|18
tag|Francesco Micheli|16
tag|Marco Guidarini|15
tag|Giulio Ciabatti|14
tag|Robert Wilson|14
tag|"Nabucco"|13
tag|Daniele Callegari|13
tag|Roberto Abbado|13
tag|"Lucia di Lammermoor"|13
tag|Vincenzo Bellini|13
tag|Paolo Arrivabeni|12
tag|Tel Aviv, Israeli Opera|12
tag|Michele Mariotti|12
tag|Yishai Steckler|12
tag|Arnaud Bernard|12
tag|Stefano Mazzonis Di Palafrera|12
tag|Nicola Paszkowski|11
tag|Giuseppe|11
tag|Fabio Ceresa|11
tag|Teatro San Carlo di Napoli|11
tag|Ancona, Teatro delle Muse|11
tag|Macerata Opera Festival|11
tag|Giampaolo Maria Bisanti|11
tag|Renato Palumbo|11
