GRAHAM F. VALENTINE|"Les contes d'Hoffmann"|Christoph Marthaler|Jacques Offenbach|Spalanzani|Staatsoper Stuttgart|Sylvain Cambreling
TERESA SEDLMAIR|"Der ferne klang"|"Don Pasquale"|"La voix humaine" e "The telephone"|-|Gaetano Donizetti|Giampaolo Bisanti|Giancarlo Menotti,Francis Poulenc|Giulio Ciabatti|Ingo Metzmacher|Jens-daniel Herzog|Jonathan Webb|Lucca|Lucy|Mizzi / eine choristen|Norina|Sandro Pasqualetto|Zurigo|giardino di Palazzo Zuckermann di Padova
LEVENTE MOLNÁR|"Parsifal"|-|Amfortas|Calixto Bieito|Staatsoper Stuttgart|Sylvain Cambreling
MARTIN WINKLER|"Parsifal"|-|Calixto Bieito|Gustavo Tambascio|Klingsor|L’altoparlante|Madrid, Teatro Real|Pedro Halffter|Staatsoper Stuttgart|Sylvain Cambreling|Viktor Ullmann|“Der Kaiser von Atlantis” di Viktor Ullmann
STEFANIA KALUSA|"Der ferne klang"|"Eugenio Onegin"|-|Der Frau des alten Graumann|Grischa Asagaroff|Ingo Metzmacher|Jens-daniel Herzog|Larina|Opernhaus di Zurigo|Vladimir Fedoseyev|Zurigo
MATTHIAS HÖLLE|"Parsifal"|-|Calixto Bieito|Staatsoper Stuttgart|Sylvain Cambreling|Titurel
VALERIJ MURGA|"Der ferne klang"|-|Dr.Vigilius|Ingo Metzmacher|Jens-daniel Herzog|Zurigo
ANDRE 'MORSCH|"Don Giovanni"|Andrea Moses|Antony Hermus|Leporello|Staatsoper Stuttgart|Wolfgang Amadeus Mozart
ROGER PADULLÉS|Arlecchino|Gustavo Tambascio|Madrid, Teatro Real|Pedro Halffter|Viktor Ullmann|“Der Kaiser von Atlantis” di Viktor Ullmann
PUMEZ MATSHIKISA|"Don Giovanni"|Andrea Moses|Antony Hermus|Staatsoper Stuttgart|Wolfgang Amadeus Mozart|Zerlina
BEATRIZ JIMÉNEZ|-|Lothar Koenigs|Romeo Castellucci|Seconda vergine|Teatro Real di Madrid|“Moses und Aron”
CARMEN ANGULO|Danzatrici CRISTINA ARIAS|Gustavo Tambascio|Madrid, Teatro Real|Pedro Halffter|Viktor Ullmann|“Der Kaiser von Atlantis” di Viktor Ullmann
ALTEA GARRIDO|"Les contes d'Hoffmann"|Christoph Marthaler|Jacques Offenbach|Staatsoper Stuttgart|Stella|Sylvain Cambreling
ANDREW RICHARDS|"Parsifal"|-|Calixto Bieito|Don José|Franco Zeffirelli|Georges Bizet|Julian Kovatchev|Parsifal|Ritorniamo|Staatsoper Stuttgart|Sylvain Cambreling|parlare della "Carmen" areniana
ROBERT MURRAY|-|George Benjamin|John / Third Angel|Madrid, Teatro Real|“Written on skin” di George Benjamin
TIM MEAD|-|George Benjamin|Madrid, Teatro Real|The Boy / First Angel|“Written on skin” di George Benjamin
ANDREW SCHROEDER|"The Bassarids"|Captain of the Royal Guard|Hans Werner Henze|Mario Martone|Stefan Soltesz|Teatro dell'Opera di Roma
ULRICH WAND|"Fidelio"|Jossi Wieler, Sergio Morabito|Ludwig Van Beethoven|Staatsoper Stuttgart|Sylvain Cambreling|Zweiter Gefangener
CHRISTOPH SOKLER|"La Juive"|Albert|Jacques Fromental Halévy|Jossi Wieler, Sergio Morabito|Staatsoper Stuttgart|Sébastien Rouland
DMITRY TRUNOV|"La Juive"|Jacques Fromental Halévy|Jossi Wieler, Sergio Morabito|Principe Léopold|Staatsoper Stuttgart|Sébastien Rouland
VICENÇ ESTEVE|-|Claus Guth,Anja Kampe|Due cavalieri del Graal|Madrid, Teatro Real|Semyon Bychkov|“Parsifal”
ANTE JERKUNIKA|-|Claus Guth,Anja Kampe|Madrid, Teatro Real|Semyon Bychkov|Titurel|“Parsifal”
DAVID SÁNCHEZ|-|Claus Guth,Anja Kampe|Due cavalieri del Graal|Madrid, Teatro Real|Semyon Bychkov|“Parsifal”
ROSIE ALDRIDGE|-|Claus Guth,Anja Kampe|Madrid, Teatro Real|Semyon Bychkov|Una voce|“Parsifal”
ANGELA DENOKE|"Jenufa"|"L'Affare Makropulos"|"Parsifal"|"Rienzi"|"Věc Makropulos"|-|Adriano|Calixto Bieito|Claus Guth|Emilia Marty|Firenze|Hugo De Ana|Kostelnička Buryjovka|Kundry|Luca Ronconi|Marko Letonja|Mikko Franck|Milano, Teatro alla Scala|Opera di Roma|Richard Wagner|Staatsoper Stuttgart|Stefan Soltesz|Sylvain Cambreling|William Friedkin|Zubin Mehta|Zurigo,Opernhaus
STEPHEN RUGAMER|"Lulu"|Alban Berg|Andrea Breth|Daniel Barenboim|Der Neger|Staatsoper Berlin
THOMAS PIFKA|"Lulu"|Alban Berg|Alwa|Andrea Breth|Daniel Barenboim|Staatsoper Berlin
WOLFGANG ABLINGER-SPERRHACKE|"Lulu"|"Siegfried"|-|Alban Berg|Alvis Hermanis|Andrea Breth|Bernd Alois Zimmermann|Daniel Barenboim|Der Kammerdiener|Ingo Metzmacher|Jossi Wieler|Marc Soustrot|Mime|Pirzel|Staatsoper Berlin|Staatsoper Stuttgart|“Die Soldaten” al Teatro alla Scala
WOLFGANG HUBSCH|"Lulu"|Alban Berg|Andrea Breth|Daniel Barenboim|Der Medizinalrat / Der Professor|Staatsoper Berlin
REBECCA JOE LOEB|"Written on Skin"|Angel 2 ' Marie|Festival d'Aix-en-Provence|George Benjamin|Katie Mitchell
KARL-FRIEDRICH DURR|"Die glückliche Hand" e "Osud"|"L' ecume des Jours" di Edison Denisov|"La Juive"|-|Der Direktor der Waffenfabrik|Jacques Fromental Halévy|Jossi Wieler, Sergio Morabito|Leoš Janáček|Lhotský|Ruggiero|Staatsoper Stuttgart|Sylvain Cambreling|Sébastien Rouland
GILLES RAGON|"La Juive"|Eléazar|Jacques Fromental Halévy|Jossi Wieler, Sergio Morabito|Staatsoper Stuttgart|Sébastien Rouland
SEBASTIAN BOLLACHER|"La Juive"|Jacques Fromental Halévy|Jossi Wieler, Sergio Morabito|Staatsoper Stuttgart|Sébastien Rouland|Un araldo
LIANG LI|"Die Zauberflöte"|"La Juive"|"La Sonnambula"|"Nabucco"|"Rigoletto"|-|Alain Altinoglu|Eugene Kohn|Gabriele Ferro|Giuliano Carella|Giuseppe Verdi|Grandioso "Nabucco"|Il Cardinale Brogni|Il Commendatore|Il conte Rodolfo|Jacques Fromental Halévy|Jossi Wieler, Sergio Morabito|Jussi Wieler, Sergio Morabito|Michael Haneke|Parigi, Opéra Bastille|Pechino|Peter Konwitschny|Rudolf Frey|Sarastro|Sparafucile|Staatsoper Stuttgart|Sylvain Cambreling|Sébastien Rouland|Uwe Sandner|Vincenzo Bellini|Wolfgang Amadeus Mozart|Zaccaria|Zaccharia|“Don Giovanni”
TATIANA PECHNIKOVA|"La Juive"|Jacques Fromental Halévy|Jossi Wieler, Sergio Morabito|Rachel|Staatsoper Stuttgart|Sébastien Rouland
NORIKO KUINOSKY|"Iphigénie en Aulide" di Gluck|Andrea Moses|Christoph Willibald Gluck|Cristoph Poppen|Statsoper Stuttgart|Une esclave
RONAN|"Iphigénie en Aulide" di Gluck|Andrea Moses|Calchas|Christoph Willibald Gluck|Cristoph Poppen|Statsoper Stuttgart
CRISTINA OTEY|"Der Rosenkavalier"|"Iphigénie en Aulide" di Gluck|Andrea Moses|Christoph Willibald Gluck|Cristoph Poppen|Marc Soustrot|Richard Strauss|Staatsoper Stuttgart|Statsoper Stuttgart|Stefan Herheim|Tre Nobili Orfane|Troi Grecques
ISOLDE DAUM|"Iphigénie en Aulide" di Gluck|Andrea Moses|Christoph Willibald Gluck|Cristoph Poppen|Statsoper Stuttgart|Troi Grecques
MOJCA ERDMANN|"Don Giovanni"|"Fidelio"|"Lulu"|Alban Berg|Alejo Pérez|Andrea Breth|Daniel Barenboim|Deborah Warner|Dmitri Tcherniakov|Ludwig Van Beethoven|Lulu|Madrid, Teatro Real|Marzelline|Milano, Teatro alla Scala|Staatsoper Berlin|Wolfgang Amadeus Mozart|Zerlina
MICHAEL VOLLE|"Lulu"|Alban Berg|Andrea Breth|Daniel Barenboim|Jack|Staatsoper Berlin
LIANA OSWALD|"Lulu"|Alban Berg|Andrea Breth|Daniel Barenboim|Die Kunstgewerblerin|Staatsoper Berlin
JURGEN LINN|"Lulu"|Alban Berg|Andrea Breth|Daniel Barenboim|Schigolch|Staatsoper Berlin
JOHANNES WERNER PREIN|"Lulu"|Alban Berg|Andrea Breth|Daniel Barenboim|Der Theaterdirektor|Staatsoper Berlin
DEBORAH POLASKI|"Lulu"|Alban Berg|Andrea Breth|Daniel Barenboim|Gräfin Geschwitz|Staatsoper Berlin
BLANKA MODRA|"Lulu"|Alban Berg|Andrea Breth|Daniel Barenboim|Die Kunstgewerblerin|Staatsoper Berlin
ANNA LAPKVOSKAJA|"Lulu"|Alban Berg|Andrea Breth|Daniel Barenboim|Ein Gymnasiast|Staatsoper Berlin
BARBARA HANNIGAN|"Written on Skin"|-|Agnes|Agnès|Festival d'Aix-en-Provence|George Benjamin|Katie Mitchell|Madrid, Teatro Real|“Written on skin” di George Benjamin
ALLAN CLAYTON|"Written on Skin"|Angel 3 ' John|Festival d'Aix-en-Provence|George Benjamin|Katie Mitchell
CHRISTOPHER PURVES|"Written on Skin"|-|Festival d'Aix-en-Provence|George Benjamin|Katie Mitchell|Madrid, Teatro Real|Philippe Jordan|Romeo Castellucci|The Protector|Un altro uomo, Ephraim|“Written on skin” di George Benjamin
BEJUN MEHTA|"Written on Skin"|Angel 1 ' The boy|Festival d'Aix-en-Provence|George Benjamin|Katie Mitchell
MANUEL GUNTHER|"Die sieben Todsünden"|Barrie Kosky|Berlino, Komische Oper|Bruder|Kristiina Poska|Kurt Weill
LINI GONG|" Götterdämmerung"|-|Marc Soustrot|Peter Konwitschny|Staatsoper Stuttgart|Woglinde
RALF LUKAS|-|Philippe Jordan|Romeo Castellucci|Un sacerdote
IRMGARD VILSMAIER|" Götterdämmerung"|-|Brünnhilde|Marc Soustrot|Peter Konwitschny|Staatsoper Stuttgart
KORA PAVELIC|"Reigen" di Philippe Boesmans|Das süße Mädel|Nicola Hümpel|Philippe Boesmans|Staatsoper Stuttgart|Sylvain Cambreling
GEORG NIGL|"Jakob Lenz"|"Lulu"|"Penthesilea"|"Von heute auf morgen", "Pagliacci"|-|Achilles|Alban Berg|Andrea Breth|Andreas Homoki|Arnold Schönberg|Bruxelles, Théâtre La Monnaie|Daniel Barenboim|Ein Athlet|Eliahu Inbal|Franck Ollu|Il marito|Jakob Lenz|Pascal Dusapin|Pierre Audi|Staatsoper Berlin|Staatsoper Stuttgart|Théâtre La Monnaie|Venezia, Teatro la Fenice|Wolfgang Rihm
THOMAS E. BAUER|"Der Rosenkavalier"|"Die Zauberflöte"|-|Accademia di Santa Cecilia|Alvis Hermanis|Bernd Alois Zimmermann|Ein Polizeikommissär|Harry Kupfer|Ingo Metzmacher|Oratore, Primo Sacerdote, Secondo Armigero|René Jacobs|Richard Strauss|Stolzius|Teatro alla Scala di Milano|Wolfgang Amadeus Mozart|Zubin Mehta|“Die Soldaten” al Teatro alla Scala
THOMAS ELWIN|"Berenice, regina di Armenia" (Il Vologeso)|"Chovanščina"|"Les contes d'Hoffmann"|-|Andrea Moses|Christoph Marthaler|Due Servi|Gabriele Ferro|Jacques Offenbach|Jossi Wieler|Kuska|Nathanaël|Niccolò Jommelli|Simon Hewett|Staatsoper Stuttgart|Sylvain Cambreling
SASA VRABAC|"Chovanščina"|-|Andrea Moses|Secondo Strelez|Simon Hewett|Staatsoper Stuttgart
CHRISTIANE LIBOR|"Siegfried"|-|Brünnhilde|Jossi Wieler|Marc Soustrot|Staatsoper Stuttgart
JAN-CRISTOF TOMERL|"Wozzeck"|-|Andrea Moses|Il bambino di Marie|Michael Schønwandt|Staatsoper Stuttgart
HEINZ GONZALO ARAYA|"Ariadne auf Naxos"|Jossi Wieler, Sergio Morabito|Michael Schøwandt|Richard Strauss|Scaramuccio|Staatsoper Stuttgart
MATTHIAS HOLLE|"Don Giovanni"|Andrea Moses|Antony Hermus|Il Commendatore|Staatsoper Stuttgart|Wolfgang Amadeus Mozart
DAVID GÖHRIG|"Ariadne auf Naxos"|Jossi Wieler, Sergio Morabito|Michael Schøwandt|Richard Strauss|Staatsoper Stuttgart|Truffaldin
ERIN CAVES|"Ariadne auf Naxos"|"The Bassarids"|-|Da Lorca a Sotelo|Emperador / Prestidigitador|Hans Werner Henze|Jossi Wieler, Sergio Morabito|Mario Martone|Michael Schøwandt|Pablo Heras-casado|Richard Strauss|Robert Castro|Staatsoper Stuttgart|Stefan Soltesz|Teatro dell'Opera di Roma|Tenore / Bacchus|Tiresias|prima mondiale di “El Público” a Madrid
EWANDRO CRUZ-STENKOWSKI|"Ariadne auf Naxos"|Jossi Wieler, Sergio Morabito|Michael Schøwandt|Richard Strauss|Staatsoper Stuttgart|Un ufficiale
HUILING ZHU|"Les Dialogues des Carmélites"|-|Manfred Honeck|Staatsoper Stuttgart|Sœur Mathilde
IVONNE FUCHS|"Die Walküre"|-|Amastre|Daniel Barenboim|Georg Friedrich Händel|Guy Cassiers|Jean-|Madrid|Milano, Teatro alla Scala|Waltraute|“Serse” di Händel
ANAIK MOREL|"Die Walküre"|"Rigoletto"|-|Daniel Barenboim|Giuseppe Verdi|Guy Cassiers|Jossi Wieler, Sergio Morabito|Maddalena|Milano, Teatro alla Scala|Schwertleite|Staatsoper Stuttgart|Sylvain Cambreling
CAROLA HÖHN|"Csarskaja Nevesta" ( sposa per lo Zar)|"Die Walküre"|-|Daniel Barenboim|Dmitri Tcherniakov|Guy Cassiers|Milano, Teatro alla Scala|Nikolaj Rimskij-korsakov|Ortlinde|Petrovna|Teatro alla Scala
LEANN SANDEL-PANTALEO|"Die Walküre"|-|Daniel Barenboim|Guy Cassiers|Milano, Teatro alla Scala|Siegrune
NICOLE PICCOLOMINI|"Die Walküre"|-|Daniel Barenboim|Deutsche Oper Berlin|Donald Runnicles|Gotz Friedrich|Gringerde|Guy Cassiers|Milano, Teatro alla Scala|Schwertleite
STEPHAN RÜGAMER|"Csarskaja Nevesta" ( sposa per lo Zar)|Daniel Barenboim|Dmitri Tcherniakov|Elisej Bomelij|Nikolaj Rimskij-korsakov|Teatro alla Scala
STEFANIA GIANNÌ|"Csarskaja Nevesta" ( sposa per lo Zar)|Cameriera|Daniel Barenboim|Dmitri Tcherniakov|Nikolaj Rimskij-korsakov|Teatro alla Scala
MASSIMILIANO DI FINO|"Csarskaja Nevesta" ( sposa per lo Zar)|Daniel Barenboim|Dmitri Tcherniakov|Nikolaj Rimskij-korsakov|Teatro alla Scala|Un giovane
GUILLERMO BUSSOLINI|"Csarskaja Nevesta" ( sposa per lo Zar)|Daniel Barenboim|Dmitri Tcherniakov|Fuochista dello zar|Nikolaj Rimskij-korsakov|Teatro alla Scala
ANNA TOMOWA-SINTOW|"Csarskaja Nevesta" ( sposa per lo Zar)|Daniel Barenboim|Dmitri Tcherniakov|Domna Ivanovna Saburova|Nikolaj Rimskij-korsakov|Teatro alla Scala
RENÉE MORLOC|"Siegfried"|-|Alvis Hermanis|Bernd Alois Zimmermann|Erda|Ingo Metzmacher|Jossi Wieler|Marc Soustrot|Staatsoper Stuttgart|Stolzius’ Mutter|“Die Soldaten” al Teatro alla Scala
MARKUS MARQUARDT|"Rigoletto"|"Salome"|"Siegfried"|-|Der Wanderer|Gabriele Ferro|Giuseppe Verdi|Jochanaan|Jossi Wieler|Jossi Wieler, Sergio Morabito|Manfred Schweigkofler|Marc Soustrot|Richard Strauss|Rigoletto|Staatsoper Stuttgart|Sylvain Cambreling|Teatro San Carlo di Napoli
JOSEFIN FEILER|"Fidelio"|"Siegfried"|"The Fairy Queen"|-|Calixto Bieito|Christian Curnyn|Henry Purcell|Jossi Wieler|Jossi Wieler, Sergio Morabito|Ludwig Van Beethoven|Marc Soustrot|Marzelline|Spring|Staatsoper Stuttgart|Sylvain Cambreling|Waldvogel
JOHN GRAHAM-HALL|"Candide"|"Die glückliche Hand" e "Osud"|"Jakob Lenz"|"Le nozze di Figaro"|-|Andrea Breth|Aron|Basilio|Bruxelles, Théâtre La Monnaie|Festival di Aix-en-Provence|Franck Ollu|Governor,Vanderdendur, Ragotsky|Jossi Wieler, Sergio Morabito|Jérémie Rhorer|Kaufmann|Leonard Bernstein|Leoš Janáček|Lorenzo Mariani|Lothar Koenigs|Philippe Jordan|Roma, Teatro dell'Opera|Romeo Castellucci|Staatsoper Stuttgart|Sylvain Cambreling|Teatro Real di Madrid|Wayne Marshall|Wolfgang Amadeus Mozart|Wolfgang Rihm|Živný|“Moses und Aron”
CATHERINE WYN-ROGERS|"Siegfried"|-|Carlus Padrissa|Donna malata|Erda|Firenze, Teatro Comunale|Lothar Koenigs|Philippe Jordan|Romeo Castellucci|Teatro Real di Madrid|Un’invalida|Zubin Mehta|“Moses und Aron”
MILCHO BOROVINOV|"Rienzi"|Hugo De Ana|Opera di Roma|Raimondo|Richard Wagner|Stefan Soltesz
JEAN LUC BALLESTRA|"Rienzi"|"Werther"|Albert|Cecco del Vecchio|Hugo De Ana|Jesùs Lopez-cobos|Jules Massenet|Opera di Roma|Richard Wagner|Stefan Soltesz|Willy Decker
DAHEYUN AHN|"Ariadne auf Naxos"|Jossi Wieler, Sergio Morabito|Michael Schøwandt|Richard Strauss|Staatsoper Stuttgart|Un parrucchiere
ANDRÉ JUNG|"Ariadne auf Naxos"|Il maggiordomo|Jossi Wieler, Sergio Morabito|Michael Schøwandt|Richard Strauss|Staatsoper Stuttgart
BOGUSLAW BIDZINSKI|"Eugenio Onegin"|-|Grischa Asagaroff|Opernhaus di Zurigo|Triquet|Vladimir Fedoseyev
PETRA MARIA SCHNITZER|"Eugenio Onegin"|-|Grischa Asagaroff|Opernhaus di Zurigo|Tatiana|Vladimir Fedoseyev
SIMON O'NEILL|"Die Walküre"|-|Daniel Barenboim|Guy Cassiers|Milano, Teatro alla Scala|Siegmund
VITALIJ KOWALJOW|"Die Walküre"|"Nabucco"|-|Ancora “Nabucco”|Daniel Barenboim|Daniele Abbado|Gianfranco De Bosio|Giuseppe Verdi|Guy Cassiers|Julian Kovatchev|Milano, Teatro alla Scala|Nicola Luisotti|Wotan|Zaccaria|’Arena di Verona
WALTRAUD MEIER|"Die Walküre"|"Elektra"|"Wozzeck"|-|Daniel Barenboim|Guy Cassiers|James Levine|Klytämnestra|Marie|Mark Lamos|Metropolitan Opera|Milano, Teatro alla Scala|Patrice Ch|Richard Strauss|Sieglinde|Teatro alla Scala di Milano
LINDSAY AMMANN|" Götterdämmerung"|"Ariadne auf Naxos"|"Die Walküre"|-|Driade|Flosshilde|James Levine|Jossi Wieler, Sergio Morabito|Marc Soustrot|Metropolitan Opera|Michael Schøwandt|Peter Konwitschny|Richard Strauss|Robert Lepage|Rossweisse|Staatsoper Stuttgart
VICTORIA SIMMONDS|-|George Benjamin|Madrid, Teatro Real|Marie / Second Angel|“Written on skin” di George Benjamin
PETER SONN|"Der ferne klang"|-|Der Chavalier / 6 Gast|Ingo Metzmacher|Jens-daniel Herzog|Zurigo
BARBARA RITA LAVARIAN|-|Milano, Teatro alla Scala|Stéphane Braunschweig|Tebaldo, paggio di Elisabetta|“Don Carlo”
ŠTEFAN KOČAN|-|Il grande Inquisitore|Milano, Teatro alla Scala|Stéphane Braunschweig|“Don Carlo”
ROBERTA SALVATI|-|Milano, Teatro alla Scala|Stéphane Braunschweig|Voce dal cielo|“Don Carlo”
DANIELLE HALBWACHS|"Die Walküre"|-|Daniel Barenboim|Gerhilde|Guy Cassiers|Milano, Teatro alla Scala
EKATERINA GUBANOVA|"Die Walküre"|-|Daniel Barenboim|Eboli|Firenze, Teatro del Maggio Musicale Fiorentino|Fricka|Giuseppe Verdi|Guy Cassiers|La principessa Eboli|Milano, Teatro alla Scala|Stéphane Braunschweig|Zubin Mehta|“Don Carlo”
RUPERT GRÖSSINGER|Alvis Hermanis|Bernd Alois Zimmermann|Ein junger Jaeger|Ingo Metzmacher|“Die Soldaten” al Teatro alla Scala
JOHN DASZAK|"The turn of the screw"|Benedetto Sicca|Benjamin Britten|Firenze, Teatro Goldoni|Jonathan Webb|Quint|The Prologue
REBECCA LEGGETT|"The turn of the screw"|Benedetto Sicca|Benjamin Britten|Firenze, Teatro Goldoni|Flora|Jonathan Webb
ANASTASIJA HARMS|"Madama Butterfly"|Dolore|Giacomo Puccini|Giuliano Carella|Monique Wagemakers|Staatsoper Stuttgart
CLAUDIA BARAINSKY|"Wunderzaichen" di Mark Andre in prima assoluta|Jossi Wieler, Sergio Morabito|Maria|Mark Andre|Staatsoper Stuttgart|Sylvain Cambreling
ANDRÉ JUNG:|"Wunderzaichen" di Mark Andre in prima assoluta|Johannes|Jossi Wieler, Sergio Morabito|Mark Andre|Staatsoper Stuttgart|Sylvain Cambreling
MATTHIAS KLINK|"Chovanščina"|"Reigen" di Philippe Boesmans|"Salome"|"Wunderzaichen" di Mark Andre in prima assoluta|-|Alvis Hermanis|Andrea Moses|Bernd Alois Zimmermann|Der Dichter|Der junge Graf|Herodes|Ingo Metzmacher|Jossi Wieler, Sergio Morabito|Kirill Serebriannikov|Mark Andre|Nicola Hümpel|Philippe Boesmans|Polizist / Erzengel|Principe Vasilij Golitzyn|Richard Strauss|Roland Kluttig|Simon Hewett|Staatsoper Stuttgart|Sylvain Cambreling|“Die Soldaten” al Teatro alla Scala
RAFAEL ROJAS|"Madama Butterfly"|"Norma"|F.B. Pinkerton|Giacomo Puccini|Giuliano Carella|Ivan Anguélov|Jossi Wieler, Sergio Morabito|Monique Wagemakers|Pollione|Staatsoper Stuttgart|Vincenzo Bellini
SOPHIE MARILLEY|"Ariadne auf Naxos"|"Berenice, regina di Armenia" (Il Vologeso)|"Der Rosenkavalier"|"Falstaff"|"L' ecume des Jours" di Edison Denisov|"Les contes d'Hoffmann"|"Platée"|-|Alise, Chicks Freundin|Andreas Moses|Calixto Bieito|Christian Curnyn|Christoph Marthaler|Gabriele Ferro|Giuseppe Verdi|Il compositore|Jacques Offenbach|Jean-philippe Rameau|Jossi Wieler|Jossi Wieler, Sergio Morabito|Junon|La Muse / Nicklausse|Marc Soustrot|Michael Schøwandt|Mrs. Meg Page|Niccolò Jommelli|Octavian|Richard Strauss|Staatsoper Stuttgart|Stefan Herheim|Sylvain Cambreling|Vologeso
ANDREAS WOLF|"Così fan tutte"|"Platée"|-|Calixto Bieito|Christian Curnyn|Guglielmo|Jean-philippe Rameau|Jupiter|Madrid, Teatro Real|Staatsoper Stuttgart|Sylvain Cambreling|Wolfgang Amadeus Mozart
CYRIL AUVITY|"Platée"|Calixto Bieito|Christian Curnyn|Jean-philippe Rameau|Staatsoper Stuttgart|Thespis / Mercure
SIMONE JACKEL|"Madama Butterfly"|Giacomo Puccini|Giuliano Carella|Kate Pinkerton|Monique Wagemakers|Staatsoper Stuttgart
DEVIS LONGO|"Fidelio"|Daniel Barenboim|Deborah Warner|Ludwig Van Beethoven|Milano, Teatro alla Scala|Zweiter Gefangener
TINA HÖRHOLD|"Parsifal"|-|Calixto Bieito|Staatsoper Stuttgart|Sylvain Cambreling|Una voce lontana
RONAN COLLETT|"Così fan tutte"|"Don Giovanni"|Andrea Moses|Antony Hermus|Guglielmo|Masetto|Staatsoper Stuttgart|Sylvain Cambreling|Wolfgang Amadeus Mozart|Yannis Houvardas
SONIA DE MUNCK|Bubikopf|Gustavo Tambascio|Madrid, Teatro Real|Pedro Halffter|Viktor Ullmann|“Der Kaiser von Atlantis” di Viktor Ullmann
TORBEN JÜRGENS|Gustavo Tambascio|Madrid, Teatro Real|Morte|Pedro Halffter|Viktor Ullmann|“Der Kaiser von Atlantis” di Viktor Ullmann
ALEJANDRO MARCO-BUHRMESTER|Gustavo Tambascio|L’imperatore</em> <em>Overall|Madrid, Teatro Real|Overall|Pedro Halffter|Viktor Ullmann|“Der Kaiser von Atlantis” di Viktor Ullmann
BLANCA PORTILLO|Gustavo Tambascio|Madrid, Teatro Real|Narratrice|Pedro Halffter|Viktor Ullmann|“Der Kaiser von Atlantis” di Viktor Ullmann
GERGELY NÈMETI|"Così fan tutte"|Ferrando|Staatsoper Stuttgart|Sylvain Cambreling|Wolfgang Amadeus Mozart|Yannis Houvardas
SIMON STRICKER|"Salome"|Ein Kappadozier|Kirill Serebriannikov|Richard Strauss|Roland Kluttig|Staatsoper Stuttgart
IDUNNU MÜNCH|"Salome"|Ein Page|Kirill Serebriannikov|Richard Strauss|Roland Kluttig|Staatsoper Stuttgart
AIN ANGER|-|Andreas Homoki|Daland|Hartmut Haenchen|Richard Wagner
ANJA KAMPE|"Fidelio"|-|Andreas Homoki|Claus Guth,Anja Kampe|Daniel Barenboim|Deborah Warner|Hartmut Haenchen|Kundry|Leonore|Ludwig Van Beethoven|Madrid, Teatro Real|Milano, Teatro alla Scala|Richard Wagner|Semyon Bychkov|Senta|“Parsifal”
DOMINIK WORTIG|-|Andreas Homoki|Der Steuermann Dalands|Hartmut Haenchen|Richard Wagner
BRYN TERFEL|"Das Rheingold"|"Der fliegende Holländer”|"Die Walküre"|-|Andreas Homoki|Daniel Harding|David Afkham|Der Holländer|Deutsche Oper Berlin|Donald Runnicles|Fabio Luisi|Giuseppe Verdi|Gotz Friedrich|Hartmut Haenchen|James Levine|Metropolitan Opera|Richard Wagner|Robert Carsen|Robert Lepage|Sir John Falstaff|Wotan|’Auditorio Nacional di Madrid
FALK STRUCKMANN|"Fidelio"|Daniel Barenboim|Deborah Warner|Don Pizarro|Ludwig Van Beethoven|Milano, Teatro alla Scala
ANA DURLOVSKI|"Ariadne auf Naxos"|"Berenice, regina di Armenia" (Il Vologeso)|"Der Rosenkavalier"|"I Puritani"|"Rigoletto"|-|Berenice|Elvira|Gabriele Ferro|Gilda|Giuliano Carella|Giuseppe Verdi|Jossi Wieler|Jossi Wieler E Sergio Morabito|Jossi Wieler, Sergio Morabito|Marc Soustrot|Michael Schøwandt|Niccolò Jommelli|Richard Strauss|Sophie|Staatsoper Stuttgart|Stefan Herheim|Sylvain Cambreling|Zerbinetta
LJUBOMIR PUSKARIC|"Rienzi"|Hugo De Ana|Opera di Roma|Paolo Orsini|Richard Wagner|Stefan Soltesz
HANNAH BRADBURY|"Rienzi"|Hugo De Ana|Opera di Roma|Richard Wagner|Stefan Soltesz|Un ambasciatore di pace
LAURA AIKIN|"Lulu"|-|Alban Berg|Alvis Hermanis|Bernd Alois Zimmermann|Daniele Gatti|Ingo Metzmacher|Lulu|Marie|Michael Schonwandt|Parigi, Opéra Bastille|Peter Stein|Teatro alla Scala|Willy Decker|“Die Soldaten” al Teatro alla Scala
FRANZ MAZURA|"Elektra"|"Lulu"|-|Daniele Gatti|Der Pfleger des Orest|Patrice Ch|Peter Stein|Richard Strauss|Schigolch/un clown|Teatro alla Scala|Teatro alla Scala di Milano
TOBIAS SCHABEL|"Parsifal"|-|Claus Guth|Klingsor|Mikko Franck|Zurigo,Opernhaus
JAN-HENDRIK ROOTERING|"Parsifal"|-|Claus Guth|Gurnemanz|Mikko Franck|Zurigo,Opernhaus
EVELYN HERLITZIUS|"Elektra"|"Lohengrin" alla Scala|"Parsifal"|"Salome"|-|Berlino, Deutsche Oper|Claus Guth|Daniel Barenboim|Donald Runnicles|Elektra|Giacomo Puccini|Harry Kupfer|Kundry|La Principessa Turandot|Non piangere'... c'è Liù|Opera di Roma|Ortrud|Patrice Ch|Philipp Stölzl|Philippe Jordan|Pinchas Steinberg|Piume di un cigno scomparso|Richard Strauss|Roberto De Simone|Salome|Staatsoper di Berlino|Teatro alla Scala di Milano
STEPHAN SCHÄFER|Alvis Hermanis|Bernd Alois Zimmermann|Drei Faehnriche / Drei Hauptleute|Ingo Metzmacher|“Die Soldaten” al Teatro alla Scala
VOLKER WAHL|Alvis Hermanis|Bernd Alois Zimmermann|Drei Faehnriche / Drei Hauptleute|Ingo Metzmacher|“Die Soldaten” al Teatro alla Scala
WERNER FRIEDL|Alvis Hermanis|Bernd Alois Zimmermann|Der Bediente der Gräfin de la Roche|Ingo Metzmacher|“Die Soldaten” al Teatro alla Scala
ANDREA BÖNIG|"Salome"|-|Accademia Nazionale di Santa Cecilia|Erda|Harry Kupfer|Kirill Petrenko|Philippe Jordan|Richard Strauss|Staatsoper di Berlino|Un paggio di Herodias|“Das Rheingold”
ARTTU KATAJA|"Salome"|Due soldati|Harry Kupfer|Philippe Jordan|Richard Strauss|Staatsoper di Berlino
BERND ZETTISCH|"Salome"|Harry Kupfer|Philippe Jordan|Richard Strauss|Staatsoper di Berlino|Un capadociano
DANIELA DENSCHLAG|"Die Walküre"|"Salome"|-|Firenze, Teatro Comunale|Fricka|Harry Kupfer|Herodias|La Fura Dels Baus (carlus Padrissa)|Philippe Jordan|Richard Strauss|Staatsoper di Berlino|Zubin Mehta
HEINZ G|"Falstaff"|Andreas Moses|Dott. Cajus|Giuseppe Verdi|Staatsoper Stuttgart|Sylvain Cambreling
HILKE ANDERSEN|"Falstaff"|Andreas Moses|Giuseppe Verdi|Mrs. Quickly|Staatsoper Stuttgart|Sylvain Cambreling
ALBERT DOHMEN|"Falstaff"|-|Andreas Moses|Giuseppe Verdi|Lothar Koenigs|Moses|Romeo Castellucci|Sir John Falstaff|Staatsoper Stuttgart|Sylvain Cambreling|Teatro Real di Madrid|“Moses und Aron”
ALEXANDER EFANOV|"La Bohème"|Andrea Moses|Giacomo Puccini|Simon Hewett|Staatsoper Stuttgart|Un Venditore
ALOIS RIEDEL|"Der Rosenkavalier"|"La Bohème"|Andrea Moses|Giacomo Puccini|Marc Soustrot|Parpignol|Richard Strauss|Simon Hewett|Staatsoper Stuttgart|Stefan Herheim|Un venditore di animali
BOGDAN BACIU|"La Bohème"|Andrea Moses|Giacomo Puccini|Marcello|Simon Hewett|Staatsoper Stuttgart
HEIKO SCHULZ|"La Bohème"|Andrea Moses|Giacomo Puccini|Sergente dei Doganieri|Simon Hewett|Staatsoper Stuttgart
KENNETH JOHN LEWIS|"La Bohème"|Alcindoro|Andrea Moses|Giacomo Puccini|Simon Hewett|Staatsoper Stuttgart
TOMMASO HAHN|"La Bohème"|Andrea Moses|Giacomo Puccini|Simon Hewett|Staatsoper Stuttgart|Un Doganiere
DONALD MCINTYRE|"Elektra"|-|Ein alter Diener|Patrice Ch|Richard Strauss|Teatro alla Scala di Milano
BONITA HYMAN|"Elektra"|-|Erste Magd|Patrice Ch|Richard Strauss|Teatro alla Scala di Milano
MARIE-EVE MUNGER|"Elektra"|-|Patrice Ch|Richard Strauss|Teatro alla Scala di Milano|Vierte Magd
RENATE BEHLE|"Elektra"|"Jenufa"|-|Calixto Bieito|Die Aufseherin / Die Vertraute|La vecchia Buryjovka|Patrice Ch|Richard Strauss|Staatsoper Stuttgart|Sylvain Cambreling|Teatro alla Scala di Milano
THOMAS RANDLE|"Elektra"|-|Aegisth|Patrice Ch|Richard Strauss|Teatro alla Scala di Milano
THEMBINKOSI MGETYENGANA|"Rigoletto"|Giuseppe Verdi|Jossi Wieler, Sergio Morabito|Paggio della Duchessa|Staatsoper Stuttgart|Sylvain Cambreling
DANIEL KLUGEN|"Rigoletto"|Borsa|Giuseppe Verdi|Jossi Wieler, Sergio Morabito|Staatsoper Stuttgart|Sylvain Cambreling
WILLIAM DAVID HALBERT|"Rigoletto"|Giuseppe Verdi|Jossi Wieler, Sergio Morabito|Staatsoper Stuttgart|Sylvain Cambreling|Usciere
RICARDA MERBETH|"Der fliegende Holländer”|"Fidelio"|-|David Afkham|Gianandrea Noseda|Leonore|Ludwig Van Beethoven|Mario Martone|Senta|Torino, Teatro Regio|’Auditorio Nacional di Madrid
TALIA OR|"Fidelio"|"Il flauto magico"|"Jenufa"|-|Accademia Nazionale di Santa Cecilia|Barena|Calixto Bieito|Christian Arming|Erste Dame|Gianandrea Noseda|Kirill Petrenko|Ludwig Van Beethoven|Mario Martone|Marzelline|Roberto Andò|Staatsoper Stuttgart|Sylvain Cambreling|Teatro Regio|Torino, Teatro Regio|Woglinde|“Das Rheingold”
LOTHAR ODINIUS|"Tannhäuser"|-|Bayreuther Festspiele|Christian Thielemann|Walther von der Vogelweide
MICHAEL NAGY|"Tannhäuser"|-|Bayreuther Festspiele|Christian Thielemann|Wolfram von Eschenbach
KATJA STUBER|"Tannhäuser"|-|Bayreuther Festspiele|Christian Thielemann|Ein junger Hirt
STEFAN RÜGAMER|"Salome"|Harry Kupfer|Narraboth|Philippe Jordan|Richard Strauss|Staatsoper di Berlino
SIMONE SCHRÖEDER|"Die Walküre"|-|Daniel Barenboim|Guy Cassiers|Milano, Teatro alla Scala|Rossweisse
SUSAN FOSTER|"Die Walküre"|-|Daniel Barenboim|Guy Cassiers|Helmwige|Milano, Teatro alla Scala
HEINZ GÖHRIG|"I Puritani"|"Parsifal"|-|Calixto Bieito|Cavalieri del Graal|Giuliano Carella|Jossi Wieler E Sergio Morabito|Sir Bruno Robertson|Staatsoper Stuttgart|Sylvain Cambreling
KRZYSZTOF SZUMANSKI|"Tancredi"|Alberto Zedda|Berlino, Deutsche Oper|Gioachino Rossini|Orbazzano|Pier Luigi Pizzi
HILA FAHIMA|"Parsifal"|"Tancredi"|-|Alberto Zedda|Berlino, Deutsche Oper|Blumenmädchen (2. Gruppe)|Donald Runnicles|Gioachino Rossini|Philipp Stölzl|Pier Luigi Pizzi|Roggiero
HADAR HALEVY|"Iphigénie en Aulide" di Gluck|"Tancredi"|Alberto Zedda|Andrea Moses|Berlino, Deutsche Oper|Christoph Willibald Gluck|Clytemnestre|Cristoph Poppen|Gioachino Rossini|Pier Luigi Pizzi|Statsoper Stuttgart|Tancredi
CLEMENTINE MARGAINE|"Die Walküre"|"Les Troyens"|"Tancredi"|-|Alberto Zedda|Anna|Berlino, Deutsche Oper|Deutsche Oper Berlin|Donald Runnicles|Gioachino Rossini|Gotz Friedrich|Gringerde|Isaura|Lawrence Foster|Marsiglia, Opéra Municipal|Pier Luigi Pizzi
ENDRIK WOTTRICH|-|Accademia Nazionale di Santa Cecilia|Froh|Kirill Petrenko|“Das Rheingold”
WOLFGANG KOCH|-|Accademia Nazionale di Santa Cecilia|Kirill Petrenko|Wotan|“Das Rheingold”
THOMAS JESATKO|"Parsifal"|"Tannhäuser"|-|Bayreuther Festspiele|Berlino, Deutsche Oper|Biterolf|Christian Thielemann|Donald Runnicles|Klingsor|Philipp Stölzl
KRISTIAN METZNER|"Tosca"|Giacomo Puccini|Marko Letonja|Staatsoper Stuttgart|Un carceriere|Willy Decker
KARL-FRIEDRICK DÜRR|"Tosca"|Giacomo Puccini|Marko Letonja|Sagrestano|Staatsoper Stuttgart|Willy Decker
LAURA VILA|-|Lothar Koenigs|Quarta vergine|Romeo Castellucci|Teatro Real di Madrid|“Moses und Aron”
OLIVER ZWARG|-|Lothar Koenigs|Romeo Castellucci|Teatro Real di Madrid|Un altro uomo/un efraimita|“Moses und Aron”
ANDREAS BAUER|"Der fliegende Holländer”|"Nabucco"|-|Daland|David Afkham|Gaetano D´espinosa|Giuseppe Verdi|Leo Muscato|Sassari, Teatro Comunale|Zaccaria|’Auditorio Nacional di Madrid
ANDREAS SCHEIBNER|-|Accademia Nazionale di Santa Cecilia|Alberich|Kirill Petrenko|“Das Rheingold”
MARK MILHOFER|"Leggenda"|"The Fairy Queen"|Alessandro De Marchi|Alessandro Solbiati|Aminta|Calixto Bieito|Christian Curnyn|Gianandrea Noseda|Giovanni Battista Pergolesi|Henry Purcell|Ivan|Queen of Secresie|Roberto De Simone|Roberto De Simone interpreta Pergolesi|Staatsoper Stuttgart|Stefano Poda|Teatro San Carlo|Torino, Teatro Carignano
OKKA VON DER DAMERAU|Alvis Hermanis|Bernd Alois Zimmermann|Charlotte|Ingo Metzmacher|“Die Soldaten” al Teatro alla Scala
MICHAEL SCHEFTS|Alvis Hermanis|Bernd Alois Zimmermann|Drei Faehnriche / Drei Hauptleute|Ingo Metzmacher|“Die Soldaten” al Teatro alla Scala
ACO BISCEVIC|Alvis Hermanis|Bernd Alois Zimmermann|Der betrunkene Offizier|Ingo Metzmacher|“Die Soldaten” al Teatro alla Scala
ANNA-EVA KÖCK|Alvis Hermanis|Bernd Alois Zimmermann|Ingo Metzmacher|Madame Roux|“Die Soldaten” al Teatro alla Scala
ALFRED MUFF|Alvis Hermanis|Bernd Alois Zimmermann|Ingo Metzmacher|Wesener|“Die Soldaten” al Teatro alla Scala
JOHANNES STERMANN|Alvis Hermanis|Bernd Alois Zimmermann|Ingo Metzmacher|Obrist|“Die Soldaten” al Teatro alla Scala
GABRIELA BEŇAČKOVÁ|Alvis Hermanis|Bernd Alois Zimmermann|Die Gräfin de la Roche|Ingo Metzmacher|“Die Soldaten” al Teatro alla Scala
MATJAŽ ROBAVS|Alvis Hermanis|Bernd Alois Zimmermann|Haudy|Ingo Metzmacher|“Die Soldaten” al Teatro alla Scala
KATHARINA DRÖSCHER|Alvis Hermanis|Artistin|Bernd Alois Zimmermann|Ingo Metzmacher|“Die Soldaten” al Teatro alla Scala
FLORIAN HOFFMANN|"Fidelio"|"Salome"|Cinque giudei|Daniel Barenboim|Deborah Warner|Harry Kupfer|Jaquino|Ludwig Van Beethoven|Milano, Teatro alla Scala|Philippe Jordan|Richard Strauss|Staatsoper di Berlino
KARIN HORVAT|"Der Rosenkavalier"|Marc Soustrot|Richard Strauss|Staatsoper Stuttgart|Stefan Herheim|Una Modista
GUDRUN WILMING|"Der Rosenkavalier"|Marc Soustrot|Richard Strauss|Staatsoper Stuttgart|Stefan Herheim|Tre Nobili Orfane
FRIEDEMANN RÖHLIG|"Der Rosenkavalier"|Il Barone Ochs von Lerchenau|Marc Soustrot|Richard Strauss|Staatsoper Stuttgart|Stefan Herheim
CATHERINE JANKE|"Les Dialogues des Carmélites"|-|Attrice|Manfred Honeck|Staatsoper Stuttgart
ANDREA MELATH|"Les Dialogues des Carmélites"|-|Manfred Honeck|Mère Marie|Staatsoper Stuttgart
HEINZ GOHRIG|"Les Dialogues des Carmélites"|-|Il cappellano|Manfred Honeck|Staatsoper Stuttgart
ROMAN SHULACKOFF|"Les Dialogues des Carmélites"|-|Le Chevalier|Manfred Honeck|Staatsoper Stuttgart
JUTTA BOHNERT|"Les Dialogues des Carmélites"|-|Blanche|Manfred Honeck|Staatsoper Stuttgart
BORJANA MATEEWA|"Salome"|Harry Kupfer|Philippe Jordan|Richard Strauss|Staatsoper di Berlino|Una schiava
MOTTI KASTÒN|"Tristan und Isolde"|-|Ein Steuermann|Jossi Wieler, Sergio Morabito|Staatsoper Stuttgart|Sylvain Cambreling
KATARINA KARNÉUS|"Tristan und Isolde"|-|Brangäne|Jossi Wieler, Sergio Morabito|Staatsoper Stuttgart|Sylvain Cambreling
TORSTEN HOFFMANN|"Madama Butterfly"|"Tristan und Isolde"|-|Ein Hirt|Giacomo Puccini|Giuliano Carella|Goro|Jossi Wieler, Sergio Morabito|Monique Wagemakers|Staatsoper Stuttgart|Sylvain Cambreling
DIONISOS TSANTINIS|"Salome"|Due soldati|Harry Kupfer|Philippe Jordan|Richard Strauss|Staatsoper di Berlino
ATALIA AYAN|"Don Giovanni"|Andrea Moses|Antony Hermus|Don Ottavio|Staatsoper Stuttgart|Wolfgang Amadeus Mozart
CATHERINE NAGLESTAD|"Norma"|"Tosca"|Floria Tosca|Giacomo Puccini|Ivan Anguélov|Jossi Wieler, Sergio Morabito|Marko Letonja|Norma|Staatsoper Stuttgart|Vincenzo Bellini|Willy Decker
MARIA TOKARSKA|"Norma"|Clotilde|Ivan Anguélov|Jossi Wieler, Sergio Morabito|Staatsoper Stuttgart|Vincenzo Bellini
DANIEL KLUGE|"Ariadne auf Naxos"|"Chovanščina"|"Elektra"|"Fidelio"|"L' ecume des Jours" di Edison Denisov|"Norma"|"Reigen" di Philippe Boesmans|"Tosca"|"Tristan und Isolde"|-|Andrea Moses|Chick, Freund von Colin|Der Soldat|Ein junger diener|Flavio|Giacomo Puccini|Il maestro di ballo|Ivan Anguélov|Jaquino|Jossi Wieler, Sergio Morabito|Lo Scrivano|Ludwig Van Beethoven|Marko Letonja|Michael Schøwandt|Nicola Hümpel|Peter Konwitschny|Philippe Boesmans|Richard Strauss|Simon Hewett|Spoletta|Staatsoper Stuttgart|Stimme eines junges Seemans|Sylvain Cambreling|Vincenzo Bellini|Willy Decker
MARINA PRUDENSKJA|"Norma"|Adalgisa|Ivan Anguélov|Jossi Wieler, Sergio Morabito|Staatsoper Stuttgart|Vincenzo Bellini
JUAN PABLO MARIN|"Fidelio"|Erster Gefangener|Jossi Wieler, Sergio Morabito|Ludwig Van Beethoven|Staatsoper Stuttgart|Sylvain Cambreling
ROSALIND PLOWRIGHT|"Die glückliche Hand" e "Osud"|"Les Dialogues des Carmélites"|-|Andreas Homoki|Hartmut Haenchen|Jossi Wieler, Sergio Morabito|La madre di Míla|Leoš Janáček|Madame de Croissy|Manfred Honeck|Mary|Richard Wagner|Staatsoper Stuttgart|Sylvain Cambreling
WOLFGANG SCHOENE|"Les Dialogues des Carmélites"|-|Manfred Honeck|Marquis de la Force|Staatsoper Stuttgart
PETER GALLIARD|-|Accademia Nazionale di Santa Cecilia|Kirill Petrenko|Loge|“Das Rheingold”
ROMAN ASTAKHOV|"Rienzi"|-|Accademia Nazionale di Santa Cecilia|Fasolt|Hugo De Ana|Kirill Petrenko|Opera di Roma|Richard Wagner|Stefan Soltesz|Stefano Colonna|“Das Rheingold”
DAGMAR PECKOVA|-|Accademia Nazionale di Santa Cecilia|Kirill Petrenko|Wellgunde|“Das Rheingold”
ANDREAS SCHAGER|"Rienzi"|Cola Rienzi|Hugo De Ana|Opera di Roma|Richard Wagner|Stefan Soltesz
MICHAEL PFLUMM|"Elektra"|-|Ein junger Diener|Il giovane nudo|Lothar Koenigs|Patrice Ch|Philippe Jordan|Richard Strauss|Romeo Castellucci|Teatro Real di Madrid|Teatro alla Scala di Milano|Un giovane nudo/un uomo|“Moses und Aron”
SILVIA HABLOWETZ|"Elektra"|-|Dritte Magd|Patrice Ch|Richard Strauss|Teatro alla Scala di Milano
KLAUS FLORIAN VOGT|"Fidelio"|"Parsifal"|-|Andreas Homoki|Berlino, Deutsche Oper|Claus Guth,Anja Kampe|Daniel Barenboim|Deborah Warner|Donald Runnicles|Erik|Florestan|Hartmut Haenchen|Ludwig Van Beethoven|Madrid, Teatro Real|Milano, Teatro alla Scala|Parsifal|Philipp Stölzl|Richard Wagner|Semyon Bychkov|“Parsifal”
THOMAS JOHANNES MAYER|"Parsifal"|-|Amfortas|Berlino, Deutsche Oper|Donald Runnicles|Moses|Philipp Stölzl|Philippe Jordan|Romeo Castellucci
MANDY FREDRICH|"Così fan tutte"|"Iphigénie en Aulide" di Gluck|"Les contes d'Hoffmann"|Andrea Moses|Antonia|Christoph Marthaler|Christoph Willibald Gluck|Cristoph Poppen|Fiordiligi|Iphigénie|Jacques Offenbach|Staatsoper Stuttgart|Statsoper Stuttgart|Sylvain Cambreling|Wolfgang Amadeus Mozart|Yannis Houvardas
URSULA HESSE VON DEN STEINEN|"Rušalka"|Antonin Dvořák|Barrie Kosky|Henrik Nánási|Komische Oper Berlin|La principessa straniera
KARL-FRIEDRICH DÜRR|"Ariadne auf Naxos"|Il professore di musica|Jossi Wieler, Sergio Morabito|Michael Schøwandt|Richard Strauss|Staatsoper Stuttgart
ROBERTO ORTIZ|"Die glückliche Hand" e "Osud"|Jossi Wieler, Sergio Morabito|Leoš Janáček|Staatsoper Stuttgart|Sylvain Cambreling|Uno studente / Hrazda
CATRIONA SMITH|"Berenice, regina di Armenia" (Il Vologeso)|"Chovanščina"|"La Cenerentola"|"La Juive"|"La Sonnambula"|-|Andrea Moses|Clorinda|Flavio|Gabriele Ferro|Gioachino Rossini|Jacques Fromental Halévy|Jossi Wieler|Jossi Wieler, Sergio Morabito|José Luis Gomesz|Jussi Wieler, Sergio Morabito|Lisa|Niccolò Jommelli|Principessa Eudoxie|Simon Hewett|Staatsoper Stuttgart|Susanna|Sébastien Rouland|Vincenzo Bellini
DANA BETH MILLER|"Parsifal"|-|Berlino, Deutsche Oper|Blumenmädchen (2. Gruppe)|Donald Runnicles|Philipp Stölzl|Stimme aus der Höhe
ANNIE ROSEN|"L’elisir d’amore"|"Parsifal"|-|Berlino, Deutsche Oper|Blumenmädchen (2. Gruppe)|Donald Runnicles|Fabio Sparvoli|Gaetano Donizetti|Giampaolo Bisanti|Giannetta|Philipp Stölzl|Torino|«Prediletti dalle stelle, / io vi lascio un gran tesoro»|“L’elisir d’amore” a Torino
ALBERT PESENDORFER|"Parsifal"|-|Berlino, Deutsche Oper|Donald Runnicles|Philipp Stölzl|Titurel
PETER RENZ|"Rušalka"|Antonin Dvořák|Barrie Kosky|Henrik Nánási|Il guardaccia|Komische Oper Berlin
MÁTÉ GÁL|"Rušalka"|Antonin Dvořák|Barrie Kosky|Henrik Nánási|Komische Oper Berlin|Un cacciatore
ASMIK GRIGORIAN|"Rušalka"|Antonin Dvořák|Barrie Kosky|Henrik Nánási|Komische Oper Berlin|Rušalka, ninfa
AGNES ZWIERKO|"Rušalka"|Antonin Dvořák|Barrie Kosky|Henrik Nánási|Ježibaba, strega|Komische Oper Berlin
JENS LARSEN|"Rušalka"|Antonin Dvořák|Barrie Kosky|Henrik Nánási|Komische Oper Berlin|Lo Spirito dell'acqua
CHRISTIANE OERTEL|"Rušalka"|Antonin Dvořák|Barrie Kosky|Henrik Nánási|Komische Oper Berlin|Lo sguattero
ASHLEY DAVID PREWETT|"Chovanščina"|"Rigoletto"|-|Andrea Moses|Giuseppe Verdi|Jossi Wieler, Sergio Morabito|Marullo|Simon Hewett|Staatsoper Stuttgart|Sylvain Cambreling|Švaklovitij
CHRISTIANNE STOTIJN|"Chovanščina"|-|Andrea Moses|Marfa|Simon Hewett|Staatsoper Stuttgart
DANIEL KALETA|"Chovanščina"|"Madama Butterfly"|-|Andrea Moses|Giacomo Puccini|Giuliano Carella|Monique Wagemakers|Primo Strelez|Simon Hewett|Staatsoper Stuttgart|Yakusidé
MATI TURI|"Chovanščina"|-|Andrea Moses|Principe Andrej Chovanskij|Simon Hewett|Staatsoper Stuttgart
MIKHAIL KAZAKOV|"Chovanščina"|-|Andrea Moses|Dosifej|Simon Hewett|Staatsoper Stuttgart
SARA HERSHKOWITZ|"The Bassarids"|"The turn of the screw"|Autonoe|Benedetto Sicca|Benjamin Britten|Bologna, Teatro Comunale|Firenze, Teatro Goldoni|Giorgio Marini|Hans Werner Henze|Jonathan Webb|L'Istitutrice|Mario Martone|Stefan Soltesz|Teatro dell'Opera di Roma|The Governess
ADAM CIOFFARI|"Ariadne auf Naxos"|"Die sieben Todsünden"|"Iphigénie en Aulide" di Gluck|Andrea Moses|Barrie Kosky|Berlino, Komische Oper|Bruder|Christoph Willibald Gluck|Cristoph Poppen|Jossi Wieler, Sergio Morabito|Kristiina Poska|Kurt Weill|Michael Schøwandt|Patrocle|Richard Strauss|Staatsoper Stuttgart|Statsoper Stuttgart|Un lacchè
DAGMAR MANZEL|"Die sieben Todsünden"|Anna|Barrie Kosky|Berlino, Komische Oper|Kristiina Poska|Kurt Weill
JOSKA LEHTINEN|"Die sieben Todsünden"|Barrie Kosky|Berlino, Komische Oper|Kristiina Poska|Kurt Weill|Vater
MARIA RICCARDA WESSELING|"La Damnation de Faust"|Andrea Moses|Hector Berlioz|Kwamé Ryan|Marguerite|Staatsoper Stuttgart
ROBERY HAYWARD|"La Damnation de Faust"|Andrea Moses|Hector Berlioz|Kwamé Ryan|Méphistophélès|Staatsoper Stuttgart
PAVEL CERNOCH|"Iolanta" e "Perséphone"|"Jenufa"|"La Damnation de Faust"|-|Andrea Moses|Calixto Bieito|Faust|Hector Berlioz|Kwamé Ryan|Laca Klemeň|Madrid, Teatro Réal|Peter Sellars|Pëtr Il’ic Cajkovskij,Igor Stravinskij|Staatsoper Stuttgart|Sylvain Cambreling|Teodor Currentzis|Vaudémont
OLIVER WIDMER|"Der ferne klang"|-|Der Graf|Ingo Metzmacher|Jens-daniel Herzog|Zurigo
ATALLA AYAN|"Falstaff"|"La Bohème"|"La Traviata"|"Nabucco"|"Rigoletto"|Alfredo Germont|Andrea Moses|Andreas Moses|Daniele Rustioni|Fenton|Ferzan Özpetek|Giacomo Puccini|Giuliano Carella|Giuseppe Verdi|Il Duca di Mantova|Ismaele|Jossi Wieler, Sergio Morabito|Petruzzelli di Bari|Rodolfo|Rudolf Frey|Simon Hewett|Staatsoper Stuttgart|Sylvain Cambreling
EWANDRO CRUZ-STENZOWSKI|"Nabucco"|Abdallo|Giuliano Carella|Giuseppe Verdi|Rudolf Frey|Staatsoper Stuttgart
ANDREA SCHWENDENER|"Der ferne klang"|-|Eine Spanierin|Ingo Metzmacher|Jens-daniel Herzog|Zurigo
IRENE FRIEDLI|"Der ferne klang"|-|Die Kellnerin|Ingo Metzmacher|Jens-daniel Herzog|Zurigo
MORGAN MOODY|"Der ferne klang"|-|Alvis Hermanis|Bernd Alois Zimmermann|Der alte Graumann/ Rudolf|Ingo Metzmacher|Jens-daniel Herzog|Mary|Zurigo|“Die Soldaten” al Teatro alla Scala
DAVIDE FERSINI|"Der ferne klang"|"La scala di seta"|-|Bepi Morassi|Der Baron / 2 Gast|Francesco Pasqualetti|Germano|Gioachino Rossini|Ingo Metzmacher|Jens-daniel Herzog|Teatro Comunale di Sassari|Zurigo
RONAN COLLET|"Nabucco"|Giuliano Carella|Giuseppe Verdi|Il Gran Sacerdote|Rudolf Frey|Staatsoper Stuttgart
SUSANNE GROBHOLZ|"Der ferne klang"|-|Ingo Metzmacher|Jens-daniel Herzog|Milli / eine ender choristen|Zurigo
ROBERTO SACCA'|"Der ferne klang"|-|Fritz|Ingo Metzmacher|Jens-daniel Herzog|Zurigo
TOMASZ SLAWINSKI|"Der ferne klang"|-|Der Wirt / 1 Gast|Ingo Metzmacher|Jens-daniel Herzog|Zurigo
THOMAS TATZL|"Der ferne klang"|-|Ingo Metzmacher|Jens-daniel Herzog|Polizist|Zurigo
ATTILA JUN|" Götterdämmerung"|"Die Walküre"|"Don Giovanni"|"Norma"|"Parsifal"|"Siegfried"|"Tristan und Isolde"|-|Calixto Bieito|Commendatore|Damiano Michieletto|Damiano Michieletto,Luca Scarzella|Deutsche Oper Berlin|Donald Runnicles|Fafner|Giuseppe Verdi|Gotz Friedrich|Gurnemanz|Hagen|Hunding|Ivan Anguélov|Jossi Wieler|Jossi Wieler, Sergio Morabito|Koenig Marke|König Marke|Magia|Marc Soustrot|Markus Dietz|Myung-whun Chung|Oroveso|Paul Curran|Peter Konwitschny|Staatsoper Stuttgart|Stefano Montanari|Sylvain Cambreling|Teatro La Fenice|Thomas Søndergård|Venezia, Teatro La Fenice|Vincenzo Bellini|Wolfgang Amadeus Mozart|Wurm|filtro, magia di Chung
MARINA FISELIER|"Jakob Lenz"|Alt 1|Andrea Breth|Bruxelles, Théâtre La Monnaie|Franck Ollu|Wolfgang Rihm
SEBASTIEN DUTRIEUX|"Béatrice et Bénédict"|"L' ecume des Jours" di Edison Denisov|-|Bruxelles, Théâtre La Monnaie|Die Maus|Don Juan|Jossi Wieler, Sergio Morabito|Richard Brunel|Samuel Jean|Staatsoper Stuttgart|Sylvain Cambreling
CLAUDIA MAHNKE|"Salome"|Herodias|Kirill Serebriannikov|Richard Strauss|Roland Kluttig|Staatsoper Stuttgart
ESTHER DIERKES|"Salome"|Ein Sklave|Kirill Serebriannikov|Richard Strauss|Roland Kluttig|Staatsoper Stuttgart
HELENE SCHNEIDERMANN|"Der Rosenkavalier"|"Madama Butterfly"|Annina|Giacomo Puccini|Giuliano Carella|Herbert Wernicke,Alejandro Stadler|Milano, Teatro alla Scala|Monique Wagemakers|Philippe Jordan|Richard Strauss|Staatsoper Stuttgart|Suzuki
INES MALAVAL|"Madama Butterfly"|Giacomo Puccini|Giuliano Carella|La Madre di Butterfly|Monique Wagemakers|Staatsoper Stuttgart
KARINE BABAJANYAN|"Madama Butterfly"|Cio Cio San|Giacomo Puccini|Giuliano Carella|Monique Wagemakers|Staatsoper Stuttgart
CLAUDIA VOTTELER|"Der Rosenkavalier"|"Madama Butterfly"|Giacomo Puccini|Giuliano Carella|La Zia|Marc Soustrot|Monique Wagemakers|Richard Strauss|Staatsoper Stuttgart|Stefan Herheim|Tre Nobili Orfane
DIANA HALLER|"Carmen"|"Così fan tutte"|"Elektra"|"I Puritani"|"La Cenerentola"|-|Andrea Moses|Angelina|Dorabella|Enrichetta di Francia|Erste Magd|Georges Bizet|Gioachino Rossini|Giuliano Carella|Jossi Wieler E Sergio Morabito|José Luis Gomesz|Mercedes|Patrick Fournillier|Peter Konwitschny|Richard Strauss|Sebastian Neubling|Staatsoper Stuttgart|Sylvain Cambreling|Wolfgang Amadeus Mozart|Yannis Houvardas
HANS KITTELMANN|"Carmen"|Georges Bizet|Patrick Fournillier|Remendado|Sebastian Neubling|Staatsoper Stuttgart
ADAM KIM|"Carmen"|"Les Dialogues des Carmélites"|"Maria Stuarda"|-|Escamillo|Gaetano Donizetti|Georges Bizet|Il carceriere/Thierry/Dr. Javelinot|Lord Guglielmo Cecil|Manfred Honeck|Marc Soustrot|Patrick Fournillier|Sebastian Neubling|Staatsoper Stuttgart
CHRISTOPH KAIL|"Carmen"|Clown|Georges Bizet|Patrick Fournillier|Sebastian Neubling|Staatsoper Stuttgart
ANJA SCHLOSSER|"Eugenio Onegin"|-|Grischa Asagaroff|Olga|Opernhaus di Zurigo|Vladimir Fedoseyev
CORNELIA KALLISCH|"Eugenio Onegin"|-|Alvis Hermanis|Bernd Alois Zimmermann|Filipjewna|Grischa Asagaroff|Ingo Metzmacher|Opernhaus di Zurigo|Vladimir Fedoseyev|Weseners alte Mutter|“Die Soldaten” al Teatro alla Scala
MATTI SALMINEN|"Aida"|"Eugenio Onegin"|"Parsifal"|-|Berlino, Deutsche Oper|Donald Runnicles|Giuseppe Verdi|Grischa Asagaroff|Gurnemanz|Milano, Teatro alla Scala|Opernhaus di Zurigo|Peter Stein|Philipp Stölzl|Principe Gremin|Ramfis|Vladimir Fedoseyev|Zubin Mehta
VALERIY MURGA|"Eugenio Onegin"|-|Grischa Asagaroff|Opernhaus di Zurigo|Saretskij|Vladimir Fedoseyev
ANDREAS HÖRL|-|Fafner|Gran Teatre del Liceu di Barcelona|Josep Pons,Robert Carsen|Lothar Koenigs|Richard Wagner|Robert Carsen|Romeo Castellucci|Teatro Real di Madrid|Un sacerdote|“Moses und Aron”|“Siegfried”
JULIE DAVIES|-|Lothar Koenigs|Philippe Jordan|Romeo Castellucci|Teatro Real di Madrid|Una fanciulla|Una fanciulla/prima vergine nuda|“Moses und Aron”
CHAE WOOK LIM|-|Philippe Jordan|Romeo Castellucci|Un uomo
MARIE-THÉRÈSE KELLER|"Lulu"|Alban Berg|Andrea Breth|Daniel Barenboim|Doppelgängerin|Ihre Mutter|Michael Schonwandt|Parigi, Opéra Bastille|Staatsoper Berlin|Willy Decker
ROBERT WÖRLE|"Lulu"|Alban Berg|Der Marquis|Michael Schonwandt|Parigi, Opéra Bastille|Willy Decker
ANDREA HILL|"Elektra"|"Lulu"|-|Alban Berg|Ein Groom|Michael Schonwandt|Parigi, Opéra Bastille|Patrice Ch|Richard Strauss|Teatro alla Scala di Milano|Willy Decker|Zweite Magd / Die Schleppträgerin
DAMIEN PASS|"Lulu"|Alban Berg|Der Journalist|Michael Schonwandt|Parigi, Opéra Bastille|Willy Decker
FRANZ GRUNDHEBER|"Lulu"|Alban Berg|Michael Schonwandt|Parigi, Opéra Bastille|Schigolch|Willy Decker
CAMILLA NYLUND|"Rusalka"|"Tannhäuser"|-|Andrew Davis|Antonin Dvořák|Barcellona, Gran Teatre del Liceu|Bayreuther Festspiele|Christian Thielemann|Elisabeth, Nichte des Landgrafen|Rusalka|Stefan Herheim
ADRIANNE PIECZONKA|"Der fliegende Holländer"|"Elektra"|-|Chrysothemis|Gianandrea Noseda|Patrice Ch|Richard Strauss|Richard Wagner|Senta|Stefan Heinrichs|Teatro alla Scala di Milano|Torino, Teatro Regio
MARC CANTURRI|"L'elisir d'amore"|"Rusalka"|Andrew Davis|Antonin Dvořák|Barcellona, Gran Teatre del Liceu|Belcore|Daniel Slater|Gaetano Donizetti|Il cacciatore|José Miguel Pérez Sierra|Opera di Oviedo|Stefan Herheim
MARTIN HOMRICH|"Rienzi"|"Tannhäuser"|-|Baroncelli|Carlus Padrissa – La Fura Dels Baus|Hugo De Ana|Opera di Roma|Richard Wagner|Stefan Soltesz|Teatro alla Scala|Walther der Vogelweide|Zubin Mehta
MARIA KORYAGOVA|"Ariadne auf Naxos"|"Die Zauberflöte"|"Nabucco"|Anna|Echo|Giuliano Carella|Giuseppe Verdi|Jossi Wieler, Sergio Morabito|Junge Papagena|Michael Schøwandt|Peter Konwitschny|Richard Strauss|Rudolf Frey|Staatsoper Stuttgart|Uwe Sandner|Wolfgang Amadeus Mozart
MOTTI KASTÓN|"Die Zauberflöte"|Peter Konwitschny|Sprecher|Staatsoper Stuttgart|Uwe Sandner|Wolfgang Amadeus Mozart
PUMEZA MATSHIKIZA|"Die Zauberflöte"|"Falstaff"|"L' ecume des Jours" di Edison Denisov|"La Bohème"|-|Andrea Moses|Andreas Moses|Giacomo Puccini|Giuseppe Verdi|Isis, Freundin von Chloé|Jossi Wieler, Sergio Morabito|Mimi|Nannetta|Pamina|Peter Konwitschny|Simon Hewett|Staatsoper Stuttgart|Sylvain Cambreling|Uwe Sandner|Wolfgang Amadeus Mozart
TORSTEN HOFMANN|"Ariadne auf Naxos"|"Der Rosenkavalier"|"Die Zauberflöte"|"Falstaff"|Andreas Moses|Bardolfo|Brighella|Giuseppe Verdi|Jossi Wieler, Sergio Morabito|Marc Soustrot|Michael Schøwandt|Monostatos|Peter Konwitschny|Richard Strauss|Staatsoper Stuttgart|Stefan Herheim|Sylvain Cambreling|Uwe Sandner|Valzacchi|Wolfgang Amadeus Mozart
ANDRÉ MORSCH|"Ariadne auf Naxos"|"Die Zauberflöte"|"La Bohème"|"Reigen" di Philippe Boesmans|"Tristan und Isolde"|-|Andrea Moses|Der Graf|Giacomo Puccini|Harlekin|Jossi Wieler, Sergio Morabito|Melot|Michael Schøwandt|Nicola Hümpel|Papageno|Peter Konwitschny|Philippe Boesmans|Richard Strauss|Schaunard|Simon Hewett|Staatsoper Stuttgart|Sylvain Cambreling|Uwe Sandner|Wolfgang Amadeus Mozart
ELKE TWIESSELMANN|"Die Zauberflöte"|Alte Papagena|Peter Konwitschny|Staatsoper Stuttgart|Uwe Sandner|Wolfgang Amadeus Mozart
REINER GOLDBERG|"Salome"|Harry Kupfer|Herodes|Philippe Jordan|Richard Strauss|Staatsoper di Berlino
VICKTOR RUD|"Salome"|Due nazareni|Harry Kupfer|Philippe Jordan|Richard Strauss|Staatsoper di Berlino
MARK DOSS|"Salome"|Harry Kupfer|Jochanaan|Philippe Jordan|Richard Strauss|Staatsoper di Berlino
JAMES HOMANN|"Salome"|Due nazareni|Harry Kupfer|Philippe Jordan|Richard Strauss|Staatsoper di Berlino
PETER-JÜRGEN SCHMIDT|"Salome"|Cinque giudei|Harry Kupfer|Philippe Jordan|Richard Strauss|Staatsoper di Berlino
PATRICK|"Salome"|Cinque giudei|Harry Kupfer|Philippe Jordan|Richard Strauss|Staatsoper di Berlino
GERALD THOMPSON|"Shell Schock"|Bruxelles, Théâtre La Monnaie|Controtenore|Koen Kessels|Nicholas Lens|Sidi Larbi Cherkaoui
GABRIEL CROZIER|"Shell Schock"|Bruxelles, Théâtre La Monnaie|Koen Kessels|Nicholas Lens|Sidi Larbi Cherkaoui|Voci bianche GABRIEL KUTY
THEO LALLY|"Shell Schock"|"The turn of the screw"|Benedetto Sicca|Benjamin Britten|Bruxelles, Théâtre La Monnaie|Firenze, Teatro Goldoni|Jonathan Webb|Koen Kessels|Miles|Nicholas Lens|Sidi Larbi Cherkaoui|Voci bianche GABRIEL KUTY
ED LYON|"Il Giustino"|"L' ecume des Jours" di Edison Denisov|"Shell Schock"|-|Antonio Vivaldi|Bruxelles, Théâtre La Monnaie|Colin|Jossi Wieler, Sergio Morabito|Koen Kessels|Nicholas Lens|Parigi, Théatre des Champs Elysées|Sidi Larbi Cherkaoui|Staatsoper Stuttgart|Sylvain Cambreling|Tenore|Vitaliano
ANAÏS MASLLORENS|"Der Schauspieldirektor", "La Canterina"|-|Bilbao, Teatro Arriaga|Ettore|Lothar Koenigs|Marco Carniti|Pablo Mielgo|Romeo Castellucci|Teatro Real di Madrid|Terza vergine|Wolfgang Amadeus Mozart,Franz Joseph Haydn|“Moses und Aron”
TIM KLASKI|"Die sieben Todsünden"|Barrie Kosky|Berlino, Komische Oper|Kristiina Poska|Kurt Weill|Mutter
ROLAND BRACHT|"Falstaff"|"Fidelio"|"I Puritani"|"L' ecume des Jours" di Edison Denisov|"Les contes d'Hoffmann"|"Rigoletto"|"Wozzeck"|-|Andrea Moses|Andreas Moses|Christoph Marthaler|Doktor Mangemanche|Giuliano Carella|Giuseppe Verdi|Il Conte di Monterone|Il dottore|Jacques Offenbach|Jossi Wieler E Sergio Morabito|Jossi Wieler, Sergio Morabito|Lord Gualtiero Valton|Ludwig Van Beethoven|Maître Luther / Crespel|Michael Schønwandt|Pistola|Rocco|Staatsoper Stuttgart|Sylvain Cambreling
KAI PREUSKER|"Wozzeck"|-|Andrea Moses|Due garzoni|Michael Schønwandt|Staatsoper Stuttgart
GERGELY NEMETI|"Wozzeck"|-|Andrea Moses|Andres|Michael Schønwandt|Staatsoper Stuttgart
CLAUDIO OTELLI|"Wozzeck"|-|Andrea Moses|Michael Schønwandt|Staatsoper Stuttgart|Wozzeck
CHRISTIANE IVEN|"Ariadne auf Naxos"|"Parsifal"|"Wozzeck"|-|Andrea Moses|Calixto Bieito|Jossi Wieler, Sergio Morabito|Kundry|Marie|Michael Schønwandt|Michael Schøwandt|Prima Donna / Ariadne|Richard Strauss|Staatsoper Stuttgart|Sylvain Cambreling
ANDREY BREUS|-|Giuseppe Verdi|Markus Dietz|Miller|Thomas Søndergård
BO YONG KIM|-|Giuseppe Verdi|Markus Dietz|Thomas Søndergård|Un contadino
DIANE HALLER|"Nabucco"|-|Fenena|Giuliano Carella|Giuseppe Verdi|Laura|Markus Dietz|Rudolf Frey|Staatsoper Stuttgart|Thomas Søndergård
DMYTRO POPOV|-|Giuseppe Verdi|Markus Dietz|Rodolfo|Thomas Søndergård
JENICE GOLBOURNE|-|Federica d'Ostheim|Giuseppe Verdi|Markus Dietz|Thomas Søndergård
SIMONE SCHNEIDER|" Götterdämmerung"|"Der Rosenkavalier"|"Don Giovanni"|"Elektra"|"Falstaff"|"Les contes d'Hoffmann"|"Maria Stuarda"|"Salome"|-|Andrea Moses|Andreas Moses|Antony Hermus|Christoph Marthaler|Chrysothemis|Die Feldmarschallin|Donna Anna|Gaetano Donizetti|Giulietta|Giuseppe Verdi|Gutrune|Jacques Offenbach|Kirill Serebriannikov|Marc Soustrot|Maria Stuarda, regina di Scozia|Mrs. Alice Ford|Peter Konwitschny|Richard Strauss|Roland Kluttig|Salome|Staatsoper Stuttgart|Stefan Herheim|Sylvain Cambreling|Wolfgang Amadeus Mozart
YALUN ZHANG|"Maria Stuarda"|-|Gaetano Donizetti|Giorgio Talbot|Marc Soustrot|Staatsoper Stuttgart
MARIA THERESA ULLRICH|"Jenufa"|"Les contes d'Hoffmann"|-|Calixto Bieito|Christoph Marthaler|Jacques Offenbach|La Moglie del Giudice|La Voix de la Tombe|Staatsoper Stuttgart|Sylvain Cambreling
ANDREAS WINKLER|"Der ferne klang"|-|Erster Chorist|Ingo Metzmacher|Jens-daniel Herzog|Zurigo
CAMILLE BUTCHER|"Der ferne klang"|-|Ingo Metzmacher|Jens-daniel Herzog|Mary|Zurigo
AGNIESZKA ADAMCZAK|"Der ferne klang"|"Luisa Miller"|-|Damiano Michieletto|Giuseppe Verdi|Ingo Metzmacher|Jens-daniel Herzog|Laura|Madchen|Opernhaus di Zurigo|Zurigo
IGOR BAKAN|"Der ferne klang"|-|Ingo Metzmacher|Jens-daniel Herzog|Zurigo|Zweiter Chorist
YVES LENOIR|"L' ecume des Jours" di Edison Denisov|-|Der Apotheker|Jossi Wieler, Sergio Morabito|Schuppentier|Staatsoper Stuttgart|Sylvain Cambreling
MARCEL BEEKMAN|"L' ecume des Jours" di Edison Denisov|-|Der Priester|Der Seneschall|Jossi Wieler, Sergio Morabito|Pégase|Staatsoper Stuttgart|Sylvain Cambreling
JEANNE SEGUIN|"L' ecume des Jours" di Edison Denisov|-|Das Mädchen|Jossi Wieler, Sergio Morabito|Staatsoper Stuttgart|Sylvain Cambreling
ARNAUD RICHARD|"L' ecume des Jours" di Edison Denisov|"The Fairy Queen"|-|Calixto Bieito|Christian Curnyn|Henry Purcell|Hymen|Jossi Wieler, Sergio Morabito|Nicolas, Colins Koch|Staatsoper Stuttgart|Sylvain Cambreling
AINSI VERWEY|"L' ecume des Jours" di Edison Denisov|-|Die Katze|Jossi Wieler, Sergio Morabito|Staatsoper Stuttgart|Sylvain Cambreling
CLARON MCFADDEN|"Shell Schock"|Bruxelles, Théâtre La Monnaie|Koen Kessels|Nicholas Lens|Sidi Larbi Cherkaoui|Soprano
ANA DURLOVSKY|"La Sonnambula"|"Les contes d'Hoffmann"|"Platée"|Amina|Amour /La Folie|Calixto Bieito|Christian Curnyn|Christoph Marthaler|Gabriele Ferro|Jacques Offenbach|Jean-philippe Rameau|Jussi Wieler, Sergio Morabito|Olympia|Staatsoper Stuttgart|Sylvain Cambreling|Vincenzo Bellini
TINA HORHOLD|"Elektra"|"Wozzeck"|-|Andrea Moses|Dritte Magd|Margret|Michael Schønwandt|Peter Konwitschny|Richard Strauss|Staatsoper Stuttgart
TUOMAS PURSIO|"Elektra"|-|Orest|Peter Konwitschny|Richard Strauss|Staatsoper Stuttgart
BARBARA SCHNEIDER-HOFSTETTER|"Elektra"|-|Elektra|Peter Konwitschny|Richard Strauss|Staatsoper Stuttgart
DANIEL BRENNA|"Elektra"|"Siegfried"|"Wozzeck"|-|Aegisth|Alvis Hermanis|Andrea Moses|Bernd Alois Zimmermann|Desportes|Il tamburmaggiore|Ingo Metzmacher|Jossi Wieler|Marc Soustrot|Michael Schønwandt|Peter Konwitschny|Richard Strauss|Siegfried|Staatsoper Stuttgart|“Die Soldaten” al Teatro alla Scala
PHILIPP ALFONS HEITMANN|"Elektra"|-|Agamemnon|Peter Konwitschny|Richard Strauss|Staatsoper Stuttgart
RENEE MORLOC|"Elektra"|-|Klytämnestra|Peter Konwitschny|Richard Strauss|Staatsoper Stuttgart
HEIDI MELTON|"Die Walküre"|-|Deutsche Oper Berlin|Donald Runnicles|Gotz Friedrich|Sieglinde
JULIA BENZINGER|"Die Walküre"|-|Deutsche Oper Berlin|Donald Runnicles|Gotz Friedrich|Rossweisse
CATHERINE FOSTER|"Die Walküre"|"Nabucco"|-|Abigaille|Brünnhilde|Deutsche Oper Berlin|Donald Runnicles|Giuliano Carella|Giuseppe Verdi|Gotz Friedrich|Gran Teatre del Liceu di Barcelona|Josep Pons,Robert Carsen|Richard Wagner|Robert Carsen|Rudolf Frey|Staatsoper Stuttgart|“Siegfried”
ELAINE MCKRILL|"Die Walküre"|-|Deutsche Oper Berlin|Donald Runnicles|Gotz Friedrich|Helmwige
ROSWITHA C.MULLER|"Die Walküre"|-|Deutsche Oper Berlin|Donald Runnicles|Gotz Friedrich|Siegrune
TORSTEN KERL|"Der fliegende Holländer”|"Die Walküre"|"Tannhäuser"|-|Bayreuther Festspiele|Christian Thielemann|David Afkham|Deutsche Oper Berlin|Donald Runnicles|Erik|Firenze, Teatro Comunale|Gotz Friedrich|La Fura Dels Baus (carlus Padrissa)|Siegmund|Tannhäuser|Zubin Mehta|’Auditorio Nacional di Madrid
MARTINA WELSCHENBACH|"Die Walküre"|-|Deutsche Oper Berlin|Donald Runnicles|Gotz Friedrich|Ortlinde
REBECCA TEEM|"Die Walküre"|-|Deutsche Oper Berlin|Donald Runnicles|Gerhilde|Gotz Friedrich
ULRIKE HELZEL|"Die Walküre"|-|Accademia Nazionale di Santa Cecilia|Deutsche Oper Berlin|Donald Runnicles|Fricka|Gotz Friedrich|Kirill Petrenko|Waltraute|“Das Rheingold”
MICHAELA SCHNEIDER|"Carmen"|"Les Dialogues des Carmélites"|-|Georges Bizet|Madame Lidoine|Manfred Honeck|Micaela|Patrick Fournillier|Sebastian Neubling|Staatsoper Stuttgart
MARK MUNKITTRICK|"Carmen"|"Der Rosenkavalier"|"Jenufa"|"L' ecume des Jours" di Edison Denisov|"La Bohème"|"La Damnation de Faust"|"Madama Butterfly"|"Parsifal"|"Tosca"|"Wozzeck"|-|Andrea Moses|Benoit|Brander|Calixto Bieito|Cavalieri del Graal|Cesare Angelotti|Due garzoni|Georges Bizet|Giacomo Puccini|Giuliano Carella|Hector Berlioz|Jesus|Jossi Wieler, Sergio Morabito|Kwamé Ryan|Lo Zio Bonzo|Marc Soustrot|Marko Letonja|Michael Schønwandt|Monique Wagemakers|Patrick Fournillier|Richard Strauss|Sebastian Neubling|Simon Hewett|Staatsoper Stuttgart|Stefan Herheim|Stárek|Sylvain Cambreling|Un Commissario di Polizia/Un Notaio|Willy Decker|Zuniga
KAI PREUSSKER|"Carmen"|"Les Dialogues des Carmélites"|-|Georges Bizet|Manfred Honeck|Morales|Patrick Fournillier|Sebastian Neubling|Staatsoper Stuttgart|Un ufficiale
HEINZ GOEHRING|"Carmen"|"Wozzeck"|-|Andrea Moses|Dancaire|Georges Bizet|Il pazzo|Michael Schønwandt|Patrick Fournillier|Sebastian Neubling|Staatsoper Stuttgart
YUKO KAKUTA|"Ariadne auf Naxos"|"Carmen"|"Così fan tutte"|"Die Zauberflöte"|"Elektra"|"Jenufa"|"La Bohème"|"Platée"|-|Andrea Moses|Calixto Bieito|Christian Curnyn|Clarin|Despina|Frasquita|Georges Bizet|Giacomo Puccini|Jano|Jean-philippe Rameau|Jossi Wieler, Sergio Morabito|Königin der Nacht|Michael Schøwandt|Musetta|Naiade|Patrick Fournillier|Peter Konwitschny|Richard Strauss|Sebastian Neubling|Simon Hewett|Staatsoper Stuttgart|Sylvain Cambreling|Uwe Sandner|Vierte Magd|Wolfgang Amadeus Mozart|Yannis Houvardas
TIMOTHY RICHARDS|"Carmen"|"Rušalka"|Antonin Dvořák|Barrie Kosky|Don José|Georges Bizet|Henrik Nánási|Il principe|Komische Oper Berlin|Patrick Fournillier|Sebastian Neubling|Staatsoper Stuttgart
TAJANA RAJ|"Carmen"|Carmen|Georges Bizet|Patrick Fournillier|Sebastian Neubling|Staatsoper Stuttgart
MIRELLA HAGEN|"Maria Stuarda"|-|Anna Kennedy|Gaetano Donizetti|Marc Soustrot|Staatsoper Stuttgart
GERGELY NEMÉTI|"Jenufa"|-|Calixto Bieito|Staatsoper Stuttgart|Sylvain Cambreling|Števa Buryja
LAURYNA BENDZIUNAITE|"Jenufa"|-|Calixto Bieito|Karolka|Staatsoper Stuttgart|Sylvain Cambreling
STINE MARIE FISCHER|"Der Rosenkavalier"|"Jakob Lenz"|"Reigen" di Philippe Boesmans|-|Alt 2|Andrea Breth|Annina|Bruxelles, Théâtre La Monnaie|Das Stubenmädchen|Franck Ollu|Marc Soustrot|Nicola Hümpel|Philippe Boesmans|Richard Strauss|Staatsoper Stuttgart|Stefan Herheim|Sylvain Cambreling|Wolfgang Rihm
ERIC ANDER|"Chovanščina"|"Jakob Lenz"|"Les contes d'Hoffmann"|"Rigoletto"|-|Andrea Breth|Andrea Moses|Bass 2|Bruxelles, Théâtre La Monnaie|Christoph Marthaler|Franck Ollu|Giuseppe Verdi|Il Conte di Ceprano|Jacques Offenbach|Jossi Wieler, Sergio Morabito|Schlémil|Simon Hewett|Staatsoper Stuttgart|Sylvain Cambreling|Warssonofjew|Wolfgang Rihm
DOMINIC GROBE|"Jakob Lenz"|-|Andrea Breth|Bass 1|Bruxelles, Théâtre La Monnaie|Franck Ollu|Staatsoper Stuttgart|Wolfgang Rihm
ANNA KOENEN|"Jakob Lenz"|-|Andrea Breth|Die kleine Friederike|Staatsoper Stuttgart
OLGA HEIKKILA|"Jakob Lenz"|-|Andrea Breth|Bruxelles, Théâtre La Monnaie|Franck Ollu|Sopran 2|Staatsoper Stuttgart|Wolfgang Rihm
IRMA MIHELIC|"Jakob Lenz"|-|Andrea Breth|Bruxelles, Théâtre La Monnaie|Franck Ollu|Sopran 1|Staatsoper Stuttgart|Wolfgang Rihm
HENRY WADDINGTON|"Jakob Lenz"|-|Andrea Breth|Bruxelles, Théâtre La Monnaie|Franck Ollu|Oberlin|Staatsoper Stuttgart|Wolfgang Rihm
REBECCA VON LIPINSKY|"Chovanščina"|"Platée"|-|Andrea Moses|Calixto Bieito|Christian Curnyn|Emma|Jean-philippe Rameau|Simon Hewett|Staatsoper Stuttgart|Thalie
HELENA SCHNEIDERMANN|"Die glückliche Hand" e "Osud"|Jossi Wieler, Sergio Morabito|La signora Stuhlá|Leoš Janáček|Staatsoper Stuttgart|Stuhlá|Sylvain Cambreling
HEINZ GOEHRIG|"Die glückliche Hand" e "Osud"|Dr. Suda|Jossi Wieler, Sergio Morabito|Leoš Janáček|Staatsoper Stuttgart|Sylvain Cambreling
ELINOR SOHN|"Die glückliche Hand" e "Osud"|Jossi Wieler, Sergio Morabito|Leoš Janáček|Součková|Staatsoper Stuttgart|Sylvain Cambreling
BARBARA FRIEBEL|"Elektra"|-|Die Aufseherin|Peter Konwitschny|Richard Strauss|Staatsoper Stuttgart
VICTOR VON HALEM|"Lulu"|Alban Berg|Der Bankier|Michael Schonwandt|Parigi, Opéra Bastille|Willy Decker
WOLFGANG SCHÖNE|"Lulu"|Alban Berg|Jack|Michael Schonwandt|Parigi, Opéra Bastille|Willy Decker
FRANK LASKE|"The Fairy Queen"|Calixto Bieito|Christian Curnyn|Henry Purcell|Priest|Staatsoper Stuttgart
JOHANN JÜRGENS|"The Fairy Queen"|Calixto Bieito|Christian Curnyn|Demetrius|Henry Purcell|Staatsoper Stuttgart
ALEXANDER SPRAGUE|"The Fairy Queen"|Calixto Bieito|Christian Curnyn|Henry Purcell|Staatsoper Stuttgart|The Indian boy
CAROLINE JUNGHANNS|"The Fairy Queen"|Calixto Bieito|Christian Curnyn|Henry Purcell|Hermia|Staatsoper Stuttgart
LAURINA BENDZIUNAITE|"Reigen" di Philippe Boesmans|"The Fairy Queen"|Calixto Bieito|Christian Curnyn|Die Dirne|Henry Purcell|Mistery|Nicola Hümpel|Philippe Boesmans|Staatsoper Stuttgart|Sylvain Cambreling
MAJA BECKMANN|"The Fairy Queen"|Calixto Bieito|Christian Curnyn|Henry Purcell|Puck|Staatsoper Stuttgart
BOAZ DANIEL|"Don Carlo"|Alvis Hermanis|Asher Fisch|Bernd Alois Zimmermann|Eisenhardt|Giuseppe Verdi|Ingo Metzmacher|Jürgen Rose|Monaco di Baviera, Bayerische Staatsoper|Rodrigo di Posa|“Die Soldaten” al Teatro alla Scala
DANIELA SINDRAM|"Die Walküre"|"Les contes d'Hoffmann"|"Rienzi"|"The Turn of the Screw"|-|Adriano|Benjamin Britten|David Mcvicar|Deutsche Oper Berlin|Donald Runnicles|Fricka|Gotz Friedrich|Jacques Offenbach|Jorge Lavelli|Josep Pons|La Muse, Nicklausse|Madrid,Teatro Real|Marko Letonja|Milano, Teatro alla Scala|Miss Jessel|Pinchas Steinberg|Richard Wagner|Robert Carsen|Toulouse, Théâtre du Capitole
ASKAR ABDRAZAKOV|"Chovanščina"|"Nabucco"|-|Andrea Moses|Antonello Allemandi|Giuseppe Verdi|Padova, Teatro Verdi|Principe Ivan Chovànskij|Simon Hewett|Staatsoper Stuttgart|Stefano Poda|Zaccaria, gran pontefice degli ebrei
NICKY SPENCE|-|Philippe Jordan|Romeo Castellucci|Un giovane
MICHAEL STILLER|"The Fairy Queen"|Calixto Bieito|Christian Curnyn|Henry Purcell|Oberon|Staatsoper Stuttgart
MANOLO BERTLING|"The Fairy Queen"|Calixto Bieito|Christian Curnyn|Henry Purcell|Lysander|Staatsoper Stuttgart
SUSANNE BÖWE|"The Fairy Queen"|Calixto Bieito|Christian Curnyn|Henry Purcell|Staatsoper Stuttgart|Titania
MIRELLA BUNOAICA|"The Fairy Queen"|Calixto Bieito|Christian Curnyn|Henry Purcell|Night|Staatsoper Stuttgart
MOTTI KASTON|"La Sonnambula"|Alessio|Gabriele Ferro|Jussi Wieler, Sergio Morabito|Staatsoper Stuttgart|Vincenzo Bellini
KARIN TORBJÖRNSDÓTTIR|"Jenufa"|"Rigoletto"|-|Calixto Bieito|Giuseppe Verdi|Jossi Wieler, Sergio Morabito|La contessa di Ceprano|Staatsoper Stuttgart|Sylvain Cambreling|Una serva
SEBASTIAN KOHLHEPP|"Berenice, regina di Armenia" (Il Vologeso)|"Reigen" di Philippe Boesmans|Der junge Herr|Gabriele Ferro|Jossi Wieler|Lucio Vero|Niccolò Jommelli|Nicola Hümpel|Philippe Boesmans|Staatsoper Stuttgart|Sylvain Cambreling
IGOR DURLOVSKI|"Berenice, regina di Armenia" (Il Vologeso)|Aniceto|Gabriele Ferro|Jossi Wieler|Niccolò Jommelli|Staatsoper Stuttgart
THRMBINKOSI MGETYENGANA|"Berenice, regina di Armenia" (Il Vologeso)|Due Servi|Gabriele Ferro|Jossi Wieler|Niccolò Jommelli|Staatsoper Stuttgart
RENÉ PAPE|"Elektra"|"Lohengrin" alla Scala|"Parsifal"|-|Asher Fisch|Claus Guth|Daniel Barenboim|Filippo II, re di Spagna|François Girard|Gurnemanz|Heinrich der Vogler|Milano, Teatro alla Scala|New York, Metropolitan|Orest|Patrice Ch|Piume di un cigno scomparso|Richard Strauss|Stéphane Braunschweig|Teatro alla Scala di Milano|“Don Carlo”
MAJA TABATADZE|"Iphigénie en Aulide" di Gluck|"Madama Butterfly"|Andrea Moses|Christoph Willibald Gluck|Cristoph Poppen|Giacomo Puccini|Giuliano Carella|La Cugina|Monique Wagemakers|Staatsoper Stuttgart|Statsoper Stuttgart|Troi Grecques
ADAM PALKA|"I Puritani"|"La Bohème"|"La Cenerentola"|-|Alidoro|Andrea Moses|Colline|Giacomo Puccini|Gioachino Rossini|Giuliano Carella|Jossi Wieler E Sergio Morabito|José Luis Gomesz|Simon Hewett|Sir Giorgio Valton|Staatsoper Stuttgart
BOGDAN MIHAI|"La Cenerentola"|Andrea Moses|Don Ramiro|Gioachino Rossini|José Luis Gomesz|Staatsoper Stuttgart
SCOTT HENDRICKS|"Death in Venice"|"Evgenij Onegin"|"Tosca"|Barone Scarpia|Benjamin Britten|Bilbao,Palacio Euskalduna|Bruno Bartoletti|Evgenij Onegin|Giacomo Puccini|La voce di Dionisio|Marko Letonja|Michal Znaniecki|Miguel Ángel Gómez Martínez|Pier Luigi Pizzi|Piotr Ilic Caikovskij|Staatsoper Stuttgart|Venezia, Teatro La Fenice|Willy Decker
NINA BERNSTEINER|-|Accademia Nazionale di Santa Cecilia|Freia|Kirill Petrenko|“Das Rheingold”
DIRK ALESCHUS|-|Accademia Nazionale di Santa Cecilia|Fafner|Kirill Petrenko|“Das Rheingold”
HERMINE HASELBÖCK|-|Accademia Nazionale di Santa Cecilia|Flosshilde|Kirill Petrenko|“Das Rheingold”
SHIGEO ISHINO|" Götterdämmerung"|"Così fan tutte"|"Die glückliche Hand" e "Osud"|"Don Giovanni"|"Iphigénie en Aulide" di Gluck|"Platée"|"Reigen" di Philippe Boesmans|"Tristan und Isolde"|-|Agamemnon|Andrea Moses|Antony Hermus|Calixto Bieito|Christian Curnyn|Christoph Willibald Gluck|Cristoph Poppen|Der Gatte|Don Alfonso|Don Giovanni|Ein mann|Gunther|Jean-philippe Rameau|Jossi Wieler, Sergio Morabito|Kurvenal|Leoš Janáček|Marc Soustrot|Momus|Nicola Hümpel|Peter Konwitschny|Philippe Boesmans|Staatsoper Stuttgart|Statsoper Stuttgart|Sylvain Cambreling|Wolfgang Amadeus Mozart|Yannis Houvardas
SYLVIA RENA ZIEGLER|"Die glückliche Hand" e "Osud"|"Elektra"|-|Jossi Wieler, Sergio Morabito|Kosinská|Leoš Janáček|Peter Konwitschny|Richard Strauss|Staatsoper Stuttgart|Sylvain Cambreling|Zweite Magd
YUN-JEONG LEE|"Die glückliche Hand" e "Osud"|Fanca Pacovská|Jossi Wieler, Sergio Morabito|Leoš Janáček|Staatsoper Stuttgart|Sylvain Cambreling
MARTIN BUKOVSEK|"Jakob Lenz"|-|Akrobat|Andrea Breth|Bruxelles, Théâtre La Monnaie|Franck Ollu|Staatsoper Stuttgart|Wolfgang Rihm
MARC LAHO|"Le comte Ory"|"Les contes d'Hoffmann"|Christoph Marthaler|Frédéric Bélier-garcia|Gioachino Rossini|Hoffmann|Jacques Offenbach|Le Comte Ory|Opéra di Marsiglia|Roberto Rizzi Brignoli|Staatsoper Stuttgart|Sylvain Cambreling
STEPHAN STORCK|"Madama Butterfly"|"Tosca"|Giacomo Puccini|Giuliano Carella|Il Commissario Imperiale|Marko Letonja|Monique Wagemakers|Sciarrone|Staatsoper Stuttgart|Willy Decker
MARIA TERESA ULLRICH|"La Cenerentola"|Andrea Moses|Gioachino Rossini|José Luis Gomesz|Staatsoper Stuttgart|Tisbe
YANA KLEYN|"The turn of the screw"|Benedetto Sicca|Benjamin Britten|Firenze, Teatro Goldoni|Jonathan Webb|Miss Jessel
SARA FULGONI|"Otello"|"Shell Schock"|"The Bassarids"|Bari, Teatro Petruzzelli|Beroe|Bruxelles, Théâtre La Monnaie|Eimuntas Nekrošius|Emilia, sua moglie|Giuseppe Verdi|Hans Werner Henze|Keri-lynn Wilson|Koen Kessels|Mario Martone|Mezzosoprano|Nicholas Lens|Sidi Larbi Cherkaoui|Stefan Soltesz|Teatro dell'Opera di Roma
TONI MARSOL|"Rusalka"|Andrew Davis|Antonin Dvořák|Barcellona, Gran Teatre del Liceu|Il guardiacaccia|Stefan Herheim
XAVIER MENDOZA|"Rusalka"|Andrew Davis|Antonin Dvořák|Barcellona, Gran Teatre del Liceu|Lo sguattero|Stefan Herheim
EMILY MAGEE|"Rusalka"|Andrew Davis|Antonin Dvořák|Barcellona, Gran Teatre del Liceu|La principessa straniera|Stefan Herheim
ILDIKÓ KOMLÓSI|"Rusalka"|Andrew Davis|Antonin Dvořák|Barcellona, Gran Teatre del Liceu|Ježibaba|Stefan Herheim
ERIK ANSTINE|"Parsifal"|-|Cavalieri del Graal|Claus Guth|Mikko Franck|Zurigo,Opernhaus
DMITRY IVANCHEY|"Der fliegende Holländer”|"Parsifal"|-|Cavalieri del Graal|Claus Guth|David Afkham|Der Steuermann Dalands|Mikko Franck|Zurigo,Opernhaus|’Auditorio Nacional di Madrid
ANDRE' MORSCH|"Die glückliche Hand" e "Osud"|"La Cenerentola"|"Platée"|Andrea Moses|Calixto Bieito|Christian Curnyn|Dandini|Gioachino Rossini|Jean-philippe Rameau|Jossi Wieler, Sergio Morabito|José Luis Gomesz|Leoš Janáček|Staatsoper Stuttgart|Sylvain Cambreling|Un Satyre / Cithéron|Verva
REBECCA VON LIPINSKI|"Der Rosenkavalier"|"Die glückliche Hand" e "Osud"|"Don Giovanni"|"Elektra"|"Fidelio"|"Jenufa"|"L' ecume des Jours" di Edison Denisov|"Reigen" di Philippe Boesmans|-|Andrea Moses|Antony Hermus|Calixto Bieito|Chloé|Die junge Frau|Donna Elvira|Fünfte Magd|Jenufa|Jossi Wieler, Sergio Morabito|Leonore (Fidelio)|Leoš Janáček|Ludwig Van Beethoven|Marc Soustrot|Marianne|Míla Válková|Nicola Hümpel|Peter Konwitschny|Philippe Boesmans|Richard Strauss|Staatsoper Stuttgart|Stefan Herheim|Sylvain Cambreling|Wolfgang Amadeus Mozart
MICHAEL EBBECKE|" Götterdämmerung"|"Der Rosenkavalier"|"Die glückliche Hand" e "Osud"|"Fidelio"|"Jenufa"|"Madama Butterfly"|"Siegfried"|-|Alberich|Calixto Bieito|Don Pizarro|Faninal|Giacomo Puccini|Giuliano Carella|Il Giudice|Jossi Wieler|Jossi Wieler, Sergio Morabito|Konečný|Leoš Janáček|Ludwig Van Beethoven|Marc Soustrot|Monique Wagemakers|Peter Konwitschny|Richard Strauss|Sharpless|Staatsoper Stuttgart|Stefan Herheim|Sylvain Cambreling
SEBASTIANA CATANA|"Nabucco"|Giuliano Carella|Giuseppe Verdi|Nabucco|Rudolf Frey|Staatsoper Stuttgart
LUCIANO BOTELHO|"La Sonnambula"|Elvino|Gabriele Ferro|Jussi Wieler, Sergio Morabito|Staatsoper Stuttgart|Vincenzo Bellini
MARTIN TZONEV|-|Accademia Nazionale di Santa Cecilia|Donner|Kirill Petrenko|“Das Rheingold”
GERGELY NÉMETI|"Anna Bolena"|"Der Rosenkavalier"|"Die Zauberflöte"|"Salome"|Gaetano Donizetti|Giancarlo Del Monaco|Kirill Serebriannikov|Lord Percy|Marc Soustrot|Massimo Zanetti|Narraboth|Peter Konwitschny|Richard Strauss|Roland Kluttig|Staatsoper Stuttgart|Stefan Herheim|Tamino|Un Cantante|Uwe Sandner|Wolfgang Amadeus Mozart|Zurigo, Opernhaus
tag|Staatsoper Stuttgart|205
tag|Sylvain Cambreling|81
tag|Richard Strauss|73
tag|Jossi Wieler, Sergio Morabito|70
tag|Andrea Moses|57
tag|Calixto Bieito|40
tag|Giuseppe Verdi|39
tag|Ingo Metzmacher|38
tag|Daniel Barenboim|38
tag|Giacomo Puccini|30
tag|Marc Soustrot|29
tag|"Die Walküre"|27
tag|Peter Konwitschny|27
tag|Milano, Teatro alla Scala|26
tag|Giuliano Carella|26
tag|"Elektra"|26
tag|Philippe Jordan|25
tag|Simon Hewett|25
tag|Wolfgang Amadeus Mozart|25
tag|Andrea Breth|24
tag|"Parsifal"|24
tag|Donald Runnicles|23
tag|"Salome"|23
tag|Alvis Hermanis|22
tag|"Lulu"|22
tag|Bernd Alois Zimmermann|22
tag|“Die Soldaten” al Teatro alla Scala|22
tag|Alban Berg|21
tag|Stefan Herheim|21
tag|Christian Curnyn|21
tag|Madrid, Teatro Real|20
tag|Richard Wagner|18
tag|"Der ferne klang"|17
tag|Jens-daniel Herzog|17
tag|Michael Schøwandt|17
tag|"Der Rosenkavalier"|17
tag|"Ariadne auf Naxos"|17
tag|Bruxelles, Théâtre La Monnaie|17
tag|Zurigo|17
tag|Willy Decker|16
tag|Harry Kupfer|16
tag|"Fidelio"|15
tag|Jossi Wieler|15
tag|Romeo Castellucci|15
tag|Staatsoper di Berlino|15
tag|Ludwig Van Beethoven|15
tag|"L' ecume des Jours" di Edison Denisov|14
tag|Deutsche Oper Berlin|14
tag|Staatsoper Berlin|14
tag|Teatro alla Scala di Milano|14
tag|Gotz Friedrich|14
tag|Antonin Dvořák|14
tag|Henry Purcell|13
tag|Barrie Kosky|13
tag|Patrice Ch|13
tag|"The Fairy Queen"|13
tag|"Die glückliche Hand" e "Osud"|13
tag|Kirill Petrenko|13
tag|Accademia Nazionale di Santa Cecilia|13
tag|Leoš Janáček|13
tag|"Chovanščina"|13
tag|"Madama Butterfly"|13
tag|Monique Wagemakers|13
tag|“Das Rheingold”|13
tag|"Rigoletto"|12
tag|"La Bohème"|12
tag|"Jenufa"|12
tag|Gioachino Rossini|12
tag|Stefan Soltesz|12
tag|Gabriele Ferro|12
tag|Georges Bizet|12
tag|Berlino, Deutsche Oper|12
tag|"Les contes d'Hoffmann"|12
tag|Jacques Offenbach|12
tag|Guy Cassiers|12
tag|"Nabucco"|11
tag|Christoph Marthaler|11
tag|Patrick Fournillier|11
tag|Vincenzo Bellini|11
tag|"Wozzeck"|11
tag|Sebastian Neubling|11
tag|Manfred Honeck|11
tag|"Les Dialogues des Carmélites"|11
tag|"Jakob Lenz"|11
tag|"Carmen"|11
