ANITA WATSON|-|Antonello Manacorda|Damiano Michieletto|Donn’Anna|Il ritorno di "Don Giovanni"|Venezia, Teatro La Fenice
ROBERTO ACCURSO|"Carmen"|"Don Giovanni"|"Il Trittico" di Giacomo Puccini|"La Bohème"|"La Traviata"|"La fanciulla del West"|"Un ballo in maschera"|Alcindoro|Alex Ollé|Barone Douphol|Benoit|Bruxelles, Théâtre La Monnaie|Carlo Rizzi|Cristiano|Damiano Michieletto|Daniele Finzi Pasca|Daniele Gatti|Daniele Rustioni|Davide Livermore|Dmitri Tcherniakov|Gaetano D’espinosa|Georges Bizet|Giacomo Puccini|Giancarlo Del Monaco|Giuseppe Verdi|Il Barone Douphol|Jader Bignamini|Jake Wallace|Leporello|Marco|Maurizio Di Mattia|Mauro Roveri|Morales|Napoli, Teatro di San Carlo|Opéra de Monte-Carlo|Paco Azorin|Pinchas Steinberg|Roma, Teatro dell'Opera|Roma,Terme di Caracalla|Sassari, Teatro Comunale|Schaunard|Sofia Coppola|Teatro alla Scala di Milano|Torre del Lago|Wolfgang Amadeus Mozart|Zubin Mehta,Eleonora Buratto
GORAN JURIC|"Nabucodonosor"|-|Antonello Manacorda|Commendatore,|Damiano Michieletto|Giuseppe Verdi|Il Gran Sacerdote di Belo|Il ritorno di "Don Giovanni"|Jean-paul Scarpitta|Riccardo Muti|Roma, Teatro dell'Opera|Venezia, Teatro La Fenice
SIMGE BUYUKEDES|"Ernani"|"Il Trittico" di Giacomo Puccini|"Lucia di Lammermoor"|"Nabucodonosor"|"Simon Boccanegra"|-|Adrian Noble|Alisa|Anna|Damiano Michieletto|Daniele Rustioni|Gaetano Donizetti|Giacomo Puccini|Giovanna, di lei nutrice|Giuseppe Verdi|Hugo De Ana|Jean-paul Scarpitta|Nella|Opera di Roma|Prima cercatrice|Riccardo Muti|Roberto Abbado|Roma, Teatro dell'Opera|Teatro dell'Opera di Roma|Un’ancella di Amelia|la stagione lirica dell'Opera di Roma
ALEX ESPOSITO|"Anna Bolena"|"Die Zauberflöte"|"Don Giovanni"|"L'Elisir d'amore"|"L'Italiana in Algeri"|"La Cenerentola"|"La clemenza di Tito" inaugura la nuova stagione|"Les contes d'Hoffmann"|"The rake's progress"|"Zelmira"|-|Alessandro Talevi|Alidoro|Ancona, Teatro delle Muse|Antonello Manacorda|Bergamo, Teatro Donizetti|Bruno Campanella|Christoph Marthaler|Corrado Rovaris|Damiano Michieletto|Damiano Michieletto,Luca Scarzella|Daniele Abbado|Davide Livermore|Diego Matheuz|Dulcamara|Enrico VIII|Faraone|Gaetano Donizetti|Gioachino Rossini|Giorgio Barberio Corsetti|Giuliano Carella|Graham Vick|Igor Stravinskij|Il Duca Alfonso|Ivo Van Hove|Jacques Offenbach|Jean-pierre Ponnelle|Josè Ramon Encinar|La Monnaie di Bruxelles|Leporello|Lindorf / Coppélius / Docteur Miracle / Dapertutto|Lodovic Morlot|Louis Langrée|Marco Guidarini|Mustafà|Nick Shadow|Nicola Berloffa|Opera di Roma|Opéra di Marsiglia|Papageno|Parigi, Palais Garnier|Peter Mussbach|Petruzzelli di Bari|Polidoro|Publio|ROF|Roberto Abbado|Roland B|Rossini Opera festival 2009|Ruggero Cappuccio|Staatsoper Stuttgart|Stefano Montanari|Sylvain Cambreling|Teatro La Fenice|Teatro La Fenice di Venezia|Teatro alla Scala|Venezia, Teatro La Fenice|Wolfgang Amadeus Mozart|una "Lucrezia Borgia" di successo
ALEXEY YAKIMOV|"Boris Godunov"|"Il Naso"|Alejo Perez|Dmitrij Šostakovič|George Pehlivanian|Hugo De Ana|Il funzionario della redazione di un giornale/Il Dottore/ secondo domestico/quinto uomo|Modest Musorgskij|Nikitič|Opera di Roma|Peter Stein|Teatro Massimo di Palermo
GRAZIANO DELLAVALLE|"La Bohéme"|Alcindoro|Cristina Mazzavillani Muti|Giacomo Puccini|Nicola Paszkowski|Novara, Teatro Coccia
ALBERTO LAZZARINI|"La Bohéme"|Cristina Mazzavillani Muti|Giacomo Puccini|Mimi|Nicola Paszkowski|Novara, Teatro Coccia
ELENA ZILIO|"Cavalleria rusticana"|"Falstaff"|"Il Naso"|"Pagliacci/Cavalleria rusticana"|-|Alejo Perez|Alessio Pizzech|Antonio Pappano|Daniel Harding|David Mcvicar|Dmitrij Šostakovič|Francesco Cilluffo|Gaetano D’espinosa|Giuseppe Verdi|Hécube|Ivan Stefanutti|Luca Ronconi|Lucia|Mamma Lucia|Mario Martone|Milano, Teatro alla Scala|Mrs. Quickly|Napoli, Teatro San Carlo|Opera di Firenze|Opera di Roma|Pelagia Podtočina|Peter Stein|Pier Luigi Pizzi|Pietro Mascagni|Pinchas Steinberg|Pippo Delbono|Roberto Parmeggiani|Sassari|Scala "Les Troyens" di Hector Berlioz|Teatro della Fortuna di Fano|Terme di Caracalla|Trionfano|Zubin Mehta|“Cavalleria Rusticana”
CLAUDIA FARNETI|"Werther"|Jesùs Lopez-cobos|Jules Massenet|Katchen|Opera di Roma|Willy Decker
LAVINIA BINI|"Die Zauberflöte"|"Don Giovanni"|"Il barbiere di Siviglia"|"Il cappello di paglia di Firenze"|"L'elisir d'amore"|"La Bohème"|"La rondine"|"Rinaldo"|-|Adina|Ancona, Teatro delle Muse “Franco Corelli”|Andrea Battistoni|Andrea Cigni|Arnaud Bernard|Berta|Brescia, Teatro Grande|Daniele Abbado|Donna/Sirena|Elena|Enrico Castiglione|Firenze, Teatro Comunale|Francesco Pasqualetti|Gabriele Bonolis|Gaetano Donizetti|Georg Friedrich Handel|Giacomo Puccini|Giampaolo Bisanti|Gino Zampieri|Gioacchino Rossini|Giovanni Battista Pergolesi|Il "Rinaldo" di Haendel-Dantone-Pizzi|Juliette Deschamps|Lisette|Lucca, Teatro del Giglio|Massimiliano Stefanelli|Musetta|Nicola Berloffa|Nino Rota|Papagena|Petruzzelli di Bari|Pier Luigi Pizzi|Ravenna|Reggio Emilia, Teatro Valli|Roland B|Sergio Alapont|Teatro Verdi di Pisa|Torino, Teatro Regio|Vittorio Borrelli|Wolfgang Amadeus Mozart|Zerbine|Zerlina
ELEONORA BURATTO|"Carmen"|"Falstaff"|"Giulio Cesare"|"I due Figaro"|"L'elisir d'amore"|"Medea"|Adina|Alessio Pizzech|Antonio Pirolli|Buenos Aires|Carmelo Rifici|Cleopatra|Cristina Mazzavillani Muti|Daniele Finzi Pasca|Emilio Sagi|Fabio Luisi|Gaetano Donizetti|Georg Friedrich Händel|Georges Bizet|Giuseppe Verdi|Glauce|Grischa Asagaroff|Luigi Cherubini|Madrid, Teatro Real|Micaëla|Milano, Teatro alla Scala|Modena, Teatro Comunale|Mrs. Alice Ford|Napoli, Teatro di San Carlo|Nicola Paszkowski|Ottavio Dantone|Reggio Emilia, Teatro Valli|Riccardo Muti|Riccardo Muti dirige "I due Figaro"|Saverio Mercadante|Susanna|Teatro Grande di Brescia|Teatro delle Muse di Ancona|Zubin Mehta,Eleonora Buratto
JACQUELIN WAGNER|"Die Zauberflöte"|Daniele Abbado|Pamina|Petruzzelli di Bari|Roland B|Wolfgang Amadeus Mozart
KRISTIAN LULA|"Die Zauberflöte"|Daniele Abbado|Petruzzelli di Bari|Primo fanciullo|Roland B|Wolfgang Amadeus Mozart
FLORIAN PLOCK|"Die Zauberflöte"|Daniele Abbado|Oratore e Primo sacerdote|Petruzzelli di Bari|Roland B|Wolfgang Amadeus Mozart
IVANA D’AURIA|"Die Zauberflöte"|Daniele Abbado|Petruzzelli di Bari|Primo fanciullo|Roland B|Wolfgang Amadeus Mozart
DIMITRY IVASCHENKO|"Die Zauberflöte"|Daniele Abbado|Petruzzelli di Bari|Roland B|Sarastro|Wolfgang Amadeus Mozart
ESTER SASSANELLI|"Die Zauberflöte"|Daniele Abbado|Petruzzelli di Bari|Roland B|Terzo fanciullo|Wolfgang Amadeus Mozart
ANNA CASTELLANETA|"Die Zauberflöte"|Daniele Abbado|Petruzzelli di Bari|Roland B|Secondo fanciullo|Wolfgang Amadeus Mozart
CHRISTINA POULITSI|"Die Zauberflöte"|"Rigoletto"|Bologna, Teatro Comunale|Daniele Abbado|Gilda|Giuseppe Verdi|Henning Brockhaus|Königin der Nacht (La regina della notte)|Luigi De Angelis|Michele Mariotti|Opera di Firenze|Petruzzelli di Bari|Regina della notte|Roland B|Wolfgang Amadeus Mozart|Zubin Mehta
DAMIANA MIZZI|"Falstaff"|"I Capuleti e i Montecchi"|"Il cappello di paglia di Firenze"|"L'italiana in Algeri"|"La Bohéme"|"La Cenerentola"|-|Alejo Pérez|Andrea De Rosa|Bruno Campanella|Christian Capocaccia|Como, Teatro Sociale|Corinda|Cristina Mazzavillani Muti|Dittico al femminile|Donato Renzetti|Elena|Elena Barbalich|Elvira|Emma Dante|Giacomo Puccini|Gioachino Rossini|Giulietta|Giuseppe La Malfa|Giuseppe Verdi|Joan Font|Musetta|Nannetta|Nicola Paszkowski|Novara, Teatro Coccia|Opera di Firenze|Petruzzelli di Bari|Reggio Emilia, Teatro Valli|Roma, Teatro dell'Opera|Sam Brown|Suor Genovieffa|Teatro delle Muse di Ancona|Vincenzo Bellini|“Goyescas” e “Suor Angelica” al Teatro Regio di Torino
VLADIMIR  REUTOV|"Il Trittico" di Giacomo Puccini|Damiano Michieletto|Daniele Rustioni|Giacomo Puccini|Roma, Teatro dell'Opera|Un venditore di canzonette
ROBERTO FRONTALI|"Attila"|"Il Trittico" di Giacomo Puccini|"Il Trovatore"|"La Traviata"|"Nabucco"|"Otello"|"Rigoletto"|"Stiffelio"|"Tosca"|-|A Firenze una "Forza del destino"|Andrea Battistoni|Arena di Verona|Bologna, Teatro Comunale|Damiano Michieletto|Daniele Abbado|Daniele Callegari|Daniele Rustioni|Diego Matheuz|Don Carlo di Vargas|Donato Renzetti|Ezio, generale romano|Georges Lavaudant|Giacomo Puccini|Gianandrea Noseda|Gianni Schicchi|Giorgio Germont|Giulio Ciabatti|Giuseppe Verdi|Guy Montavon|Hugo De Ana|Il "Trittico" secondo Michieletto|Il Barone Scarpia|Il Conte di Luna|Il barone Scarpia|Il conte di Luna|Jader Bignamini|Jago|Michele|Nabucco|Nicolas Joël|Palermo, Teatro Massimo|Parma, Teatro Regio|Paul Curran|Rani Calderon|Reggio Emilia, Teatro Valli|Renato Palumbo|Rigoletto|Roma, Teatro dell'Opera|Serena Sinigaglia|Sofia Coppola|Stankar|Teatro La Fenice|Teatro Regio di Parma|Teatro Regio di Torino|Theater an der Wien|Trieste, Teatro Verdi|Verona, Teatro Filarmonico|Walter Sutcliffe|’insegna del patriottismo
PASQUALE SCIRCOLI|"Il cappello di paglia di Firenze"|"L'Olimpiade"|-|Aminta|Bologna, Teatro Comunale|Elena Barbalich|Giuseppe La Malfa|Josef Mysliveček|Ludek Golàt|Oliver Von Dohànyi|Petruzzelli di Bari|Una guardia
ANDREA PORTA|"Il Trittico" di Giacomo Puccini|"La Bohème"|"La Traviata"|"Le nozze di Figaro"|"Madama Butterfly"|"Rusalka" al San Carlo di Napoli|Antonin Dvořák|Betto di Signa|Damiano Michieletto|Daniele Gatti|Daniele Rustioni|Dmitri Tcherniakov|Fano, Teatro della Fortuna|Figaro|Francesco Ivan Ciampa|Giacomo Puccini|Giuseppe Verdi|Guardacaccia|Il "Trittico" secondo Michieletto|Il marchese D’Obigny|Il principe Yamadori/Yakusidé|Jader Bignamini|John Fiore|Leo Muscato|Macerata Opera Festival|Manfred Schweigkofler|Marchese D’Obigny|Marco|Mario Martone|OperaLombardia,  Teatro Sociale di Como|Paolo Arrivabeni|Pierluigi Pizzi|Rani Calderon|Roma, Teatro dell'Opera|Schaunard|Sofia Coppola|Stefano Montanari|Teatro Fraschini di Pavia|Teatro alla Scala di Milano|Theater an der Wien|Tra attrazione e sventura|Wolfgang Amadeus Mozart
PAOLO RUMETZ|"Don Quichotte"|"Roberto Devereux"|"Tosca"|Bruno Campanella|Daniel Cohen,Marco Faelli|Donato Renzetti|Duca di Nottingham|Federico Tiezzi|Francesco Bellotto|Gaetano Donizetti|Giacomo Puccini|Giulio Ciabatti|Il sagrestano|Jules Massenet|Pordenone|Sancho|Teatro Lirico di Cagliari|Trieste, Teatro Verdi
LEO PAUL CHIAROT|"Il Trittico" di Giacomo Puccini|Damiano Michieletto|Daniele Rustioni|Giacomo Puccini|Pinellino|Roma, Teatro dell'Opera
ERIKA BERETTI|"Il Trittico" di Giacomo Puccini|Damiano Michieletto|Daniele Rustioni|Giacomo Puccini|Roma, Teatro dell'Opera|Seconda cercatrice
MAXIM AKSENOV|"Il Trittico" di Giacomo Puccini|Damiano Michieletto|Daniele Rustioni|Giacomo Puccini|Luigi|Roma, Teatro dell'Opera
LORENZO GIAMBENEDETTI|"Il Trittico" di Giacomo Puccini|Damiano Michieletto|Daniele Rustioni|Gherardino|Giacomo Puccini|Roma, Teatro dell'Opera
ROSSELLA CERIONI|"Il Trittico" di Giacomo Puccini|Damiano Michieletto|Daniele Rustioni|Giacomo Puccini|La suora infermiera|Roma, Teatro dell'Opera
REUT VENTOTERO|"Il Trittico" di Giacomo Puccini|Damiano Michieletto|Daniele Rustioni|Giacomo Puccini|Roma, Teatro dell'Opera|Seconda conversa
NAOMI RHOMBERG|"Anna Bolena"|Elisabetta I|Gaetano Donizetti|Giancarlo Del Monaco|Massimo Zanetti|Zurigo, Opernhaus
MIROSLAV CHRISTOFF|"Anna Bolena"|"Il Naso"|Alejo Perez|Dmitrij Šostakovič|Gaetano Donizetti|Giancarlo Del Monaco|Massimo Zanetti|Nono poliziotto/un uomo anziano|Opera di Roma|Peter Stein|Sir Hervey|Zurigo, Opernhaus
MASSIMO CAVALLETI|"Anna Bolena"|Gaetano Donizetti|Giancarlo Del Monaco|Lord Rocheford|Massimo Zanetti|Zurigo, Opernhaus
JUDITH SCHMID|"Anna Bolena"|Gaetano Donizetti|Giancarlo Del Monaco|Massimo Zanetti|Smeton|Zurigo, Opernhaus
EKATERINA SADOVNIKOVA|"Die Zauberflöte"|"Falstaff"|"Idomeneo, re di Creta"|"Il Trittico" di Giacomo Puccini|"La traviata"|"Le nozze di Figaro"|"Pagliacci", "Gianni Schicchi"|"Rigoletto"|"Werther"|-|Alessandro Talevi|Antonello Manacorda|Catania|Damiano Michieletto|Daniel Harding|Daniele Abbado|Daniele Rustioni|Diego Matheuz|Due Amanti|Due amanti|Federico Grazzini|Firenze, Teatro del Maggio Musicale Fiorentino|Francesco Ivan Ciampa|Giacomo Puccini|Gilda|Giuseppe Verdi|Henning Brockhau|Il "Trittico" secondo Michieletto|Ilia|Jeffrey Tate|Jesùs Lopez-cobos|Jules Massenet|Lauretta|Luca Ronconi|Nannetta|Opera di Firenze|Opera di Roma|Pamina|Parma, Teatro Regio|Rani Calderon|Reggio Emilia, Teatro Valli|Robert Carsen|Roma, Teatro dell'Opera|Sergio Alapont|Sophie|Suor Genoveffa|Suor Genovieffa|Susanna|Theater an der Wien|Venezia, Teatro La Fenice|Violetta Valéry|Voce dal cielo|Willy Decker|Wolfgang Amadeus Mozart|Zubin Mehta|“Don Carlo”
GAIA PETRONE|"Il novello Giasone"|-|Alinda, Pittura|Antonio Greco|Damiano Michieletto|Festival della Valle d'Itria|Giacomo Puccini|Il "Trittico" secondo Michieletto|Juliette Deschamps|Rani Calderon|Suor infermiera|Theater an der Wien
BEATRICE MEZZANOTTE|"Il Trittico" di Giacomo Puccini|"Pimpinone"|Damiano Michieletto|Daniele Rustioni|Giacomo Puccini|Gianni Gualdoni|Nicola Procaccini|Roma, Teatro dell'Opera|Suor Osmina/la novizia|Tomaso Albinoni|Vespetta|galleria Pianetti di Jesi
JOHANNA KRKOVAY|Damiano Michieletto|Giacomo Puccini|Il "Trittico" secondo Michieletto|Rani Calderon|Seconda conversa|Theater an der Wien
JURGEN SACHER|Damiano Michieletto|Gherardo|Giacomo Puccini|Il "Trittico" secondo Michieletto|Il Tinca|Rani Calderon|Theater an der Wien
LEONID SUSHON|Damiano Michieletto|Gherardino|Giacomo Puccini|Il "Trittico" secondo Michieletto|Rani Calderon|Theater an der Wien
LILJA GUDMUNDSDOTTIR|Damiano Michieletto|Giacomo Puccini|Il "Trittico" secondo Michieletto|La novizia / Suor Osmina|Rani Calderon|Theater an der Wien
MARIE-NICOLE LEMIEUX|"Falstaff"|"Un ballo in maschera"|-|Alex Ollé|Bruxelles, Théâtre La Monnaie|Carlo Rizzi|Damiano Michieletto|Daniel Harding|Daniele Gatti|Giacomo Puccini|Giuseppe Verdi|Il "Trittico" secondo Michieletto|La zia principessa|Mrs. Quickly|Rani Calderon|Robert Carsen|Teatro alla Scala di Milano|Theater an der Wien|Ulrica Arfvidsson|Zita
MAXIM AXSENOV|Damiano Michieletto|Giacomo Puccini|Il "Trittico" secondo Michieletto|Luigi|Rani Calderon|Theater an der Wien
MILENA ARSOVSKA|Damiano Michieletto|Due suore cercatrici|Giacomo Puccini|Il "Trittico" secondo Michieletto|Rani Calderon|Theater an der Wien
PATRICIA RACETTE|"Il Trittico" di Giacomo Puccini|Damiano Michieletto|Daniele Rustioni|Giacomo Puccini|Giorgetta|Giorgietta|Il "Trittico" secondo Michieletto|Rani Calderon|Roma, Teatro dell'Opera|Suor Angelica|Theater an der Wien
RUPERT BERGMANN|Damiano Michieletto|Giacomo Puccini|Il "Trittico" secondo Michieletto|Maestro Spineloccio|Rani Calderon|Theater an der Wien
GIUSEPPINA BRIDELLI|"Carmen"|"Cin-Ci-là"|"Così fan tutte"|"Die Zauberflöte"|"Il novello Giasone"|"L'Italiana in Algeri"|"La Cenerentola"|"La Traviata"|-|Alfonso Antoniozzi|Antonio Greco|Bologna, Teatro Comunale|Carlo Lombardo|Daniele Abbado|Daniele Finzi Pasca|Despina|Elisabetta Maschio|Ferzan Ozpetek|Festival della Valle d'Itria|Flora Bervoix|Francesco Esposito|Georges Bizet|Gioachino Rossini|Giuseppe Verdi|Juliette Deschamps|Maurizio Nichetti|Mercédès|Michele Mariotti|Myosotis|Napoli, Teatro di San Carlo|Nello Santi|Paolo Olmi|Petruzzelli di Bari|Poesia, Amore|Roland B|Seconda dama|Teatro Comunale di Bologna|Teatro Filarmonico di Verona|Teatro San Carlo di Napoli|Tisbe|Wolfgang Amadeus Mozart|Zubin Mehta,Eleonora Buratto|Zulma
MICHELE MELE|"La figlia del reggimento"|Alessandro D'agostini|Andrea Cigni|Cremona, Teatro Ponchielli|Gaetano Donizetti|Notaio
GIORGIO TRUCCO|"Falstaff"|"Il Trovatore"|"La Bohéme"|"La Traviata"|"Maometto II"|"Norma"|-|Benoit|Cristina Mazzavillani Muti|Daniele Rustioni|Dottor Cajus|E Cristina disse|Flavio|Gastone, visconte di Letorieres|Giacomo Puccini|Gioachino Rossini|Giuseppe Verdi|Nicola Paszkowski|Novara, Teatro Coccia|Opera di Roma|Pavia, Teatro Fraschini|Pier Luigi Pizzi|Pierpaolo Pacini|Ravenna, Teatro Alighieri|Reggio Emilia, Teatro Valli|Roberto Abbado|Ruiz|Selimo|Teatro delle Muse di Ancona|Un Messo|Vincenzo Bellini|“ Facciamo Trovatore… ”
ROSOLINO CLAUDIO CARDILE|"La Traviata"|Giuseppe|Giuseppe Verdi|Jader Bignamini|Roma, Teatro dell'Opera|Sofia Coppola
ERNESTO PETTI|"La Traviata"|Daniele Gatti|Dario Argento|Dmitri Tcherniakov|Domestico di Flora|Francesco Ivan Ciampa|Giuseppe Sabbatini|Giuseppe Verdi|Leo Nucci è Simon Boccanegra|Malcolm|Novara|Riccardo Canessa|Teatro Municipale di Piacenza|Teatro alla Scala di Milano|Un capitano dei balestrieri|«Pien di misfatti è calle della potenza». “Macbeth” di Verdi
LUCIA CONTE|"Crispino e la Comare"|Alessandro Talevi|Jader Bignamini|Lisetta|Luigi E Federico Ricci|Martina Franca
STEFANIA BONFANDELLI|"Crispino e la Comare"|Alessandro Talevi|Annetta|Jader Bignamini|Luigi E Federico Ricci|Martina Franca
MARIA JOSE SIRI|"Un ballo in maschera"|Alex Ollé|Amelia|Bruxelles, Théâtre La Monnaie|Carlo Rizzi|Giuseppe Verdi
PIERRE DERHET|"Un ballo in maschera"|Alex Ollé|Bruxelles, Théâtre La Monnaie|Carlo Rizzi|Giuseppe Verdi|Un Servo
TIJL FAVEJTS|"Un ballo in maschera"|Alex Ollé|Bruxelles, Théâtre La Monnaie|Carlo Rizzi|Giuseppe Verdi|Ribbig
ZENO POPESCU|"Un ballo in maschera"|Alex Ollé|Bruxelles, Théâtre La Monnaie|Carlo Rizzi|Giuseppe Verdi|Un Giudice
KIM BEGLEY|"Il prigioniero", "Il castello del duca Barbablù"|"Salome"|Béla Bartók|Daniel Harding|Gabriele Ferro|Herodes|Il grande Inquisitore|Manfred Schweigkofler|Milano, Teatro alla Scala|Peter Stein|Richard Strauss|Teatro San Carlo di Napoli
GIUSEPPE PIZZICATO|"La figlia del reggimento"|Alessandro D'agostini|Andrea Cigni|Cremona, Teatro Ponchielli|Gaetano Donizetti|Ortensio
CAROLA GLASER|Damiano Michieletto|Due suore cercatrici|Giacomo Puccini|Il "Trittico" secondo Michieletto|Nella|Rani Calderon|Theater an der Wien
ANDREW OWENS|Damiano Michieletto|Giacomo Puccini|Il "Trittico" secondo Michieletto|Rani Calderon|Theater an der Wien|Un venditore di canzonette
FREDERIKKE KAMPMANN|Damiano Michieletto|Giacomo Puccini|Il "Trittico" secondo Michieletto|Prima conversa / Suor Dolcina|Rani Calderon|Theater an der Wien
CELIA SOTOMAYOR|Damiano Michieletto|Giacomo Puccini|Il "Trittico" secondo Michieletto|La maestra delle novizie|Rani Calderon|Theater an der Wien
CAMILLA DE FALLEIRO|"Il Trionfo del Tempo e del Disinganno"|Bellezza|Calixto Bieito|Georg Frideric Handel|Staatsoper Stuttgart|Sébastien Rouland
NYAMDORI ENKHBAT|"Il Naso"|Alejo Perez|Dmitrij Šostakovič|I due figli della dama elegante MARCO SEVERIN|Opera di Roma|Peter Stein
DANIELE MASSIMI|"Il Barbiere di Siviglia"|"Il Trittico" di Giacomo Puccini|"La Traviata"|Damiano Michieletto|Daniele Rustioni|Domestico di Flora|Giacomo Puccini|Gioachino Rossini|Giuseppe Verdi|Guccio|Jader Bignamini|Lorenzo Mariani|Roma, Teatro dell'Opera|Roma, Terme di Caracalla|Sofia Coppola|Stefano Montanari|Un Ufficiale
MAXIM SAZHIN|"Il Naso"|Alejo Perez|Dmitrij Šostakovič|Opera di Roma|Peter Stein|Primo figlio/Jarižkin
DANIELA FOÀ|"Die Zauberflöte"|Antonello Manacorda|Damiano Michieletto|Una vecchia|Venezia, Teatro La Fenice|Wolfgang Amadeus Mozart
ISABEL DE PAOLI|"Falstaff"|"Il Trittico" di Giacomo Puccini|"Il Trovatore"|"La Traviata"|-|Cristina Mazzavillani Muti|Damiano Michieletto|Daniele Rustioni|Flora Bervoix|Giacomo Puccini|Giuseppe Verdi|Ines|La maestra delle novizie|Mrs. Quickly|Nicola Paszkowski|Ravenna, Teatro Alighieri|Reggio Emilia, Teatro Valli|Roma, Teatro dell'Opera|Teatro delle Muse di Ancona
DIONISIA DI VICO|"La figlia del reggimento"|Alessandro D'agostini|Andrea Cigni|Cremona, Teatro Ponchielli|Gaetano Donizetti|Marchesa di Lauffen
SOLISTI DEL MÜNCHNER KNABENCHOR|"Die Zauberflöte"|Antonello Manacorda|Damiano Michieletto|Tre Geni|Venezia, Teatro La Fenice|Wolfgang Amadeus Mozart
GORAN JURIĆ|"Die Zauberflöte"|Antonello Manacorda|Damiano Michieletto|Sarastro|Venezia, Teatro La Fenice|Wolfgang Amadeus Mozart
NICOLA PAMIO|"Don Quichotte"|"Falstaff"|"Il Campiello" un "hit"|"Il Trittico" di Giacomo Puccini|"La Traviata"|"Nabucco"|"Rigoletto"|"Samson et Dalila"|"Tosca"|"Turandot"|-|Abdallo|Altoum|Angelo Bertini|Bardolfo|Camille Saint-saëns|Carlus Padrissa/la Fura Dels Baus|Charles Dutoit|Damiano Michieletto|Daniel Cohen,Marco Faelli|Daniele Gatti|Daniele Rustioni|Dmitri Tcherniakov|Doge|Dona Pasqua Polegana|Donato Renzetti|Ermanno Wolf-ferrari|Federico Tiezzi|Festival Pucciniano|Francesco Ivan Ciampa|Francesco Rosa|Gherardo|Giacomo Puccini|Gilbert Deflo|Giulio Ciabatti|Giuseppe|Giuseppe Verdi|Gustavo Dudamel|Il Tinca|Jules Massenet|Jürgen Flimm|Leo Muscato|Marcello Mottadelli|Marco Balderi|Matteo Borsa|Maurizio Scaparro|Milano, Teatro alla Scala|Muhai Tang|Opera di Roma|Palermo, Teatro di Verdura|Pang|Paolo Trevisi|Pasqua Polegana|Renzo Giacchieri|Rodriguez|Roma, Teatro dell'Opera|Salerno, Teatro Verdi|Sessantesimo Festival Puccini, Torre del Lago|Sociale di Rovigo|Spoletta|Stefano Romani|Teatro Lirico di Cagliari|Teatro alla Scala|Teatro alla Scala di Milano|Trieste, Teatro Verdi|Un Messagero Filisteo|Verona, Teatro Filarmonico|Willy Landin|“Otello” di Rossini
ANNA MALAVASI|"Falstaff"|"Il Trittico" di Giacomo Puccini|"Il Trovatore"|"L'Enfant Prodigue" e "Cavalleria Rusticana"|"La Traviata"|"Macbeth"|"Madama Butterfly"|"Nabucco"|"Nabucodonosor"|"Ola" per Rigoletto|"Otello"|"Rigoletto"|"Zaira"|-|Ancona, Teatro delle Muse|Arena di Verona|Arnaud Bernard|Azucena|Carla Delfrate|Cristina Mazzavillani Muti|Dama di Lady Macbeth|Damiano Michieletto|Daniele Abbado|Daniele Rustioni|Diego Matheuz|E Cristina disse|Emilia|Fenena|Flora Bervoix|Giacomo Puccini|Giacomo Sagripanti|Gianfranco De Bosio|Giorgio Ferrara|Giuseppe Verdi|Henning Brockhaus|Ivo Guerra|Jader Bignamini|Jean-paul Scarpitta|Julian Kovatchev|La Badessa|La Ciesca|La Frugola|Maddalena|Mrs. Meg Page|Nerestano|Nicola Paszkowski|Opera di Firenze|Palermo|Parma, Teatro Regio|Peter Stein|Pietro Mascagni,Claude Debussy|Pinchas Steinberg|Ravenna, Teatro Alighieri|Reggio Emilia, Teatro Valli|Renato Palumbo|Riccardo Frizza|Riccardo Muti|Roma, Teatro dell'Opera|Roma,Teatro dell'Opera|Rosetta Cucchi|Santuzza|Sofia Coppola|Suzuki|Teatro delle Muse di Ancona|Venezia, Teatro La Fenice|Vincenzo Bellini|XXXVIII° Festival della Valle d'Itria|Zubin Mehta|“ Facciamo Trovatore… ”
ANTONIO CORIANO|-|Cristina Mazzavillani Muti|E Cristina disse|Giuseppe Verdi|Manrico|“ Facciamo Trovatore… ”
NICOLAS BOVE|"Die Zauberflöte"|Daniele Abbado|Petruzzelli di Bari|Roland B|Terzo fanciullo|Wolfgang Amadeus Mozart
PIERPAOLO GALLONE|"Die Zauberflöte"|Daniele Abbado|Petruzzelli di Bari|Roland B|Secondo fanciullo|Wolfgang Amadeus Mozart
PATRIZIO SAUDELLI|"Falstaff"|"Il Naso"|"Il Viaggio a Reims"|"Uno sguardo dal ponte"|-|Alejo Perez|Bardolfo|Daniele Gatti|David Levi|Dmitrij Šostakovič|Frank Galati|Giuseppe Verdi|Luca Ronconi|Mike|Opera di Roma|Ottavio Dantone|Peter Stein|Robert Carsen|Roma, Teatro dell'Opera|Secondo conoscente di Kovalĕv|Teatro alla Scala|Teatro alla Scala di Milano|William Bolcom|Zefirino
DOMENICO PASSIDOMO|"Il cappello di paglia di Firenze"|-|Elena Barbalich|Giuseppe La Malfa|Minardi|Petruzzelli di Bari
FRANCESCA ASCIOTI|"Il cappello di paglia di Firenze"|"Juditha Triumphans"|-|Alessandro De Marchi|Antonio Vivaldi|Elena Barbalich|Giuseppe La Malfa|La baronessa di Champigny|Ozias|Petruzzelli di Bari|Venezia, Teatro La Fenice
ANNAMARIA BELLOCCHIO|"Il cappello di paglia di Firenze"|-|Elena Barbalich|Giuseppe La Malfa|La modista|Petruzzelli di Bari
FRANCESCA BICCHIERRI|"Il cappello di paglia di Firenze"|-|Anaide|Elena Barbalich|Giuseppe La Malfa|Petruzzelli di Bari
GIUSEPPE IPPOLITO|"Il cappello di paglia di Firenze"|-|Elena Barbalich|Giuseppe La Malfa|Petruzzelli di Bari|Un caporale delle guardie
DARIO CIOTOLI|"Il Naso"|"La Traviata"|-|Abbazia di San Galgano|Alejo Perez|Alessio|Bepi Morassi|Beppe De Tomasi|Dmitrij Šostakovič|Gabriele Ferro|Giuseppe Verdi|Il lacché della Contessa/Il poliziotto del giardino d’estate/L’Aiduca/terzo poliziotto|Il marchese D’Obigny|Matteo Beltrami|Opera di Roma|Peter Stein|Vincenzo Bellini
STEFANO CONSOLINI|"Il Naso"|"Il cappello di paglia di Firenze"|"La Traviata"|"La Vedova Allegra"|"La vedova allegra"|"Les contes d'Hoffmann"|"Macbeth"|"Roméo et Juliette"|"Turandot"|-|Alejo Perez|Altoum|Andrea Battistoni|Benvolio|Bologna, Teatro Comunale|Charles Gounod|Christian Capocaccia|Christoph Campestrini|Dmitrij Šostakovič|Domestico di Macbeth|Elena Barbalich|Fabio Mastrangelo|Federico Tiezzi|Franz Lehar|Franz Lehár|Frédéric Roels|Gastone di Letorières|Gastone, visconte di Letorières|Giacomo Puccini|Giampaolo Maria Bisanti|Giuseppe Verdi|Henning Brockhaus|Hugo De Ana|Jacques Offenbach|Julian Kovatchev|Kromow|Lo zio Vezinet/Visconte Achille|Manfred Schweigkofler|Modena, Teatro Comunale|Nathanael|Nino Rota|Opera di Roma|Ottavo poliziotto/settimo uomo|Peter Stein|Pietro Rizzo|Pritschitsch|Roberto De Simone|Rosetta Cucchi|Savona|Teatro Fraschini di Pavia|Teatro Regio di Torino|Trieste, Teatro Verdi|Verona «o cara, noi rivedremo»'...ancora “Traviata”|Verona, Teatro Filarmonico|Yves Abel|’Arena
FRANCESCO PAOLO VULTAGGIO|"Adriana Lecouvreur"|"Il cappello di paglia di Firenze"|"L'elisir d'amore"|"La figlia del reggimento"|-|Alessandro D'agostini|Andrea Battistoni|Andrea Cigni|Arnaud Bernard|Belcore|Brescia, Teatro Grande|Carlo Goldstein|Comunale di Sassari|Cremona, Teatro Ponchielli|Elena Barbalich|Emilio|Francesco Cilea|Gaetano Donizetti|Giuseppe La Malfa|Ivan Stefanutti|Michonnet|Petruzzelli di Bari|Sulplizio|Teatro Sociale di Como
ANDREA TABILI|"La figlia del reggimento"|Alessandro D'agostini|Andrea Cigni|Cremona, Teatro Ponchielli|Gaetano Donizetti|Il caporale
LEONID BOMSTEIN|"Il Naso"|"Lady Macbeth del distretto di Mzesnk"|Alejo Perez|Dimitrij Sostakovic|Dmitrij Šostakovič|Firenze, Teatro Comunale|Il Naso|James Conlon|Lev Dodin|Opera di Roma|Peter Stein|Un balordo
NATASCHA PETRINSKY|"A Midsummer night's dream"|"A midsummer night's dream"|"Götterdämmerung"|"Il Trittico" di Giacomo Puccini|"Lady Macbeth del distretto di Mzesnk"|"Lulu"|"Penthesilea"|"Salome"|-|Benjamin Britten|Carmen|Contessa Geschwitz/ Una guardarobiera del teatro|Damiano Michieletto|Daniele Gatti|Daniele Rustioni|Dimitrij Sostakovic|Firenze, Teatro Comunale|Franck Ollu|Gabriele Ferro|Georges Bizet|Giacomo Puccini|Gustavo Dudamel|Gustavo Dudamel dirige "Carmen"|Herodias|Hippolyta|Hippolyta, Regina delle Amazzoni|James Conlon|Jeffrey Tate|Lev Dodin|Los Angeles|Manfred Schweigkofler|Opera di Roma|Pascal Dusapin|Paul Curran|Penthesilea|Peter Stein|Pierre Audi|Richard Strauss|Robert Carsen|Roma, Teatro dell'Opera|Sir Andrew Davis|Sonetka|Teatro San Carlo di Napoli|Teatro alla Scala|Théâtre La Monnaie|Venezia, Teatro La Fenice|Waltraute|Zita detta la vecchia
RUSLAN ROZYEV|"Il Naso"|Alejo Perez|Dmitrij Šostakovič|Opera di Roma|Peter Stein|Settimo domestico/Il cocchiere della diligenza/sesto uomo
LAURA BALDASSARI|-|Cristina Mazzavillani Muti|E Cristina disse|Giuseppe Verdi|Ines|“ Facciamo Trovatore… ”
ALESSANDRO MOR|"L'elisir d'amore"|Andrea Battistoni|Arnaud Bernard|Assistente di Dulcamara|Brescia, Teatro Grande|Gaetano Donizetti
DORELA CELA|"L'elisir d'amore"|Andrea Battistoni|Arnaud Bernard|Brescia, Teatro Grande|Gaetano Donizetti|Giannetta
VIOLETA URMANA|"Il Trittico" di Giacomo Puccini|"La forza del destino"|-|A Firenze una "Forza del destino"|Damiano Michieletto|Daniele Rustioni|Donna Leonora|Giacomo Puccini|Giuseppe Verdi|Jean-claude Auvray|La zia Principessa|Nicolas Joël|Parigi, Opéra|Roma, Teatro dell'Opera|’insegna del patriottismo
RUDOLF ROSEN|"Lulu"|-|Daniele Gatti|Peter Stein|Teatro alla Scala|Un domatore/un atleta
MAGDALENA ANNA HOFFMANN|"Lulu"|-|Daniele Gatti|Peter Stein|Teatro alla Scala|Uno studente/Gromm
GIOVANNI LUCINI|"Lulu"|-|Commissario di polizia|Daniele Gatti|Peter Stein|Teatro alla Scala
BERTRAM KLAMP|"Lulu"|-|Daniele Gatti|Peter Stein|Teatro alla Scala|Un domestico
CLAUDIA BANDERA|"Lulu"|-|Daniele Gatti|Peter Stein|Teatro alla Scala|Un’arredatrice
STEPHEN WEST|"Lulu"|-|Daniele Gatti|Dottor Schon/Jack|Peter Stein|Teatro alla Scala
THOMAS PIFFKA|"Lulu"|-|Alwa|Daniele Gatti|Peter Stein|Teatro alla Scala
IRINA ALEXEENKO|"Il Naso"|Alejo Perez|Dmitrij Šostakovič|Opera di Roma|Peter Stein|Praskov’ja Osipovna
ANTONIO TASCHINI|"Candide"|"Il Naso"|"La Gioconda"|Alejo Perez|Amilcare Ponchielli|Bear-keeper|Dmitrij Šostakovič|Due Dandies|Due Dandies MAURIZIO ROSSI|Leonard Bernstein|Lorenzo Mariani|Opera di Roma|Peter Stein|Pier Luigi Pizzi|Roberto Abbado|Roma, Teatro dell'Opera|Un pilota|Wayne Marshall
PERVIN CHAKAR|"Die Zauberflöte"|"L'Olimpiade"|"Lulu"|"Maria Stuarda"|-|Anna Kennedy|Bologna, Teatro Comunale|Daniele Abbado|Daniele Gatti|Denis Krief|Fabrizio Maria Carminati|Fenice di Venezia|Gaetano Donizetti|Josef Mysliveček|Ludek Golàt|Megacle|Oliver Von Dohànyi|Peter Stein|Petruzzelli di Bari|Prima dama|Roland B|Teatro alla Scala|Una quindicenne|Wolfgang Amadeus Mozart
FRANCESCA DOTTO|"La Traviata"|"Lucrezia Borgia"|-|Alfredo Corno|Daniele Rustioni|Ferzan Özpetek|Francesco Lanzillotta|Gaetano Donizetti|Giulio Ciabatti|Giuseppe Verdi|Henning Brockhaus|Jader Bignamini|Lucrezia Borgia|Opera Di Firenze,Fabrizio Maria Carminati|Opera di Firenze, Cortile di Palazzo Pitti|Petruzzelli di Bari|Roma, Teatro dell'Opera|Sofia Coppola|Tiziano Severini|Verdi di Padova|Violetta|Violetta Valery|Violetta Valéry
MACIEJ IDZIOREK|Damiano Michieletto|Giacomo Puccini|Il "Trittico" secondo Michieletto|Pinellino|Rani Calderon|Theater an der Wien
ROBERT HOLZER|"Fidelio"|"Salome"|Don Fernando|Gabriele Ferro|Gianandrea Noseda|Ludwig Van Beethoven|Manfred Schweigkofler|Mario Martone|Richard Strauss|Teatro San Carlo di Napoli|Torino, Teatro Regio|Zwei Nazarener
VALERI TURMANOV|"Il Naso"|"Rigoletto"|"Zaira"|Alejo Perez|Dmitrij Šostakovič|Giacomo Sagripanti|Gilbert Deflo|Giuseppe Verdi|Gustavo Dudamel|Meledor|Milano, Teatro alla Scala|Opera di Roma|Peter Stein|Quinto domestico/decimo poliziotto/secondo nuovo venuto|Rosetta Cucchi|Usciere|Vincenzo Bellini|XXXVIII° Festival della Valle d'Itria
MICHELA ANTENUCCI|"La Traviata"|"Zaira"|Annina|Fatima|Ferzan Ozpetek|Giacomo Sagripanti|Giuseppe Verdi|Michele Mariotti|Napoli, Teatro di San Carlo|Nello Santi|Rosetta Cucchi|Teatro San Carlo di Napoli|Vincenzo Bellini|XXXVIII° Festival della Valle d'Itria
SAIOA HERNANDEZ|"Norma"|"Zaira"|Giacomo Sagripanti|Norma|Padova, Teatro Verdi|Paolo Miccichè|Rosetta Cucchi|Tiziano Severini|Vincenzo Bellini|XXXVIII° Festival della Valle d'Itria|Zaira
DOMENICO COLAIANNI|"Crispino e la Comare"|"Die Zauberflöte"|"DonTrastullo"|"Falstaff"|"Il Trittico" di Giacomo Puccini|"Il cappello di paglia di Firenze"|"La Bohème"|"La Traviata"|"La Vedova allegra"|"La muette de Portici"|"Tosca"|-|Alain Guingal|Alberto Veronesi|Alessandro Talevi|Alfred Eschwé|Bari, Teatro Petruzzelli|Benoit|Borella|Crispino|Damiano Michieletto|Daniel-francois-esprit Auber|Daniele Abbado|Daniele Rustioni|Don Trastullo|Elena Barbalich|Emma Dante|Fabio Mastrangelo|Federico Tiezzi|Ferzan Özpetek|Franco Zeffirelli|Franz Lehár|Giacomo Puccini|Giuseppe La Malfa|Giuseppe Verdi|Gustavo Dudamel|Hugo De Ana|Il Talpa|Il Visconte Cascada|Il marchese d’Obigny|Il sagrestano|Jader Bignamini|Luca Ronconi|Luigi E Federico Ricci|Martina Franca|Michele Mirabella|Milano, Teatro alla Scala|Napoli, Teatrino di Corte|Nino Rota|Nonancourt|Petruzzelli di Bari|Pistola|Riccardo Canessa|Roland B|Roma, Teatro dell'Opera|Rovigo, Teatro Sociale|Sagrestano|San Carlo di Napoli|Savona|Secondo armigero e una voce|Simone|Wolfgang Amadeus Mozart
MARIA MUDRYAK|"Don Pasquale"|"La Bohéme"|Andrea Cigni|Christopher Franklin|Cristina Mazzavillani Muti|Gaetano Donizetti|Giacomo Puccini|Mimì|Nicola Paszkowski|Norina|Novara, Teatro Coccia|OperaLombardia, Teatro Donizetti di Bergamo
MICHAEL LEIBUNDGUT|"Die Zauberflöte"|"Idomeneo, re di Creta"|"The rake's progress"|Alessandro Talevi|Antonello Manacorda|Damiano Michieletto|Diego Matheuz|Igor Stravinskij|Jeffrey Tate|La voce dell'Oracolo|Oratore|Teatro La Fenice di Venezia|Trulove|Venezia, Teatro La Fenice|Wolfgang Amadeus Mozart
STELLA GRIGORIAN|Damiano Michieletto|Giacomo Puccini|Il "Trittico" secondo Michieletto|La Ciesca|La Frugola|La badessa|Rani Calderon|Theater an der Wien
ESTHER ZAGLIA|"Il flauto magico"|-|Christian Arming|Erster Knabe|Roberto Andò|Teatro Regio
ELENA SCAMUZZI|"Il flauto magico"|-|Christian Arming|Roberto Andò|Teatro Regio|Zweiter Knabe
FRANCESCO CASTORO|"Crispino e la Comare"|"Die Zauberflöte"|"Il cappello di paglia di Firenze"|"La Traviata"|"La cena delle beffe"|"Madama Butterfly"|-|Achille di Rosalba|Alessandro Talevi|Bortolo|Carlo Rizzi|Daniele Abbado|Daniele Rustioni|Elena Barbalich|Fabio Ceresa|Ferzan Özpetek|Giacomo Puccini|Giuseppe|Giuseppe Finzi|Giuseppe La Malfa|Giuseppe Verdi|Goro|Il Trinca|Jader Bignamini|Lo zio Vézinet|Luigi E Federico Ricci|Mario Martone|Martina Franca|Milano, Teatro alla Scala|Petruzzelli di Bari|Primo armigero e secondo sacerdote|Roland B|Teatro Petruzzelli di Bari|Umberto Giordano|Wolfgang Amadeus Mozart
OLGA PUDOVA|"Die Zauberflöte"|"Il flauto magico"|-|Antonello Manacorda|Christian Arming|Damiano Michieletto|Königin der Nacht|Regina della notte|Roberto Andò|Teatro Regio|Venezia, Teatro La Fenice|Wolfgang Amadeus Mozart
GIULIA MORETTO|"Il flauto magico"|-|Christian Arming|Dritte Knabe|Roberto Andò|Teatro Regio
MARA ZAMPIERI|"La Traviata"|Annina|Daniele Gatti|Dmitri Tcherniakov|Giuseppe Verdi|Teatro alla Scala di Milano
ŽELIKO LUČIĆ|"La Traviata"|Daniele Gatti|Dmitri Tcherniakov|Giorgio Germont|Giuseppe Verdi|Teatro alla Scala di Milano
ALESSIA NADIN|"Dido and Aeneas"|"Don Giovanni"|"Il Trittico" di Giacomo Puccini|"Il flauto magico"|"L'Italiana in Algeri"|"L'italiana in Algeri"|"La Cenerentola"|"Les contes d'Hoffmann"|"Norma"|"Tancredi"|-|Brescia, Teatro Grande|Christian Arming|Christian Capocaccia|Clotilde|Damiano Michieletto|Daniele Rustioni|Francesco Cilluffo|Francesco Frongia|Francesco Lanzillotta|Francesco Pasqualetti|Frédéric Roels|Giacomo Puccini|Giacomo Sagripanti|Gioachino Rossini|Graham Vick|Henry Purcell|Jacques Offenbach|José Luis Gomez-rios|La suora zelatrice|Marina Bianchi|Nicklausse|Padova, Teatro Verdi|Paolo Miccichè|Pavia, Teatro Fraschini|Pier Luigi Pizzi|Prima strega|Regio di Torino|Roberto Andò|Roggiero|Roma, Teatro dell'Opera|Rosetta Cucchi|Stefano Montanari|Teatro Fraschini di Pavia|Teatro Regio|Teatro Sociale di Como|Tisbe|Tiziano Severini|Verona|Verona, Teatro Ristori|Vincenzo Bellini|Vittorio Borrelli|Wolfgang Amadeus Mozart|Zerlina|Zulma|Zweite Dame
CESAR BELLO|"Il Naso"|Alejo Perez|Dmitrij Šostakovič|Opera di Roma|Ottavo domestico/secondo figlio|Peter Stein
CESARE RUTA|"Il Naso"|Alejo Perez|Dmitrij Šostakovič|Opera di Roma|Peter Stein|Un conoscente/un viaggiatore
ALEXEY SULIMOV|"Il Naso"|Alejo Perez|Dmitrij Šostakovič|Il commissario di polizia del quartiere|Opera di Roma|Peter Stein
ANDREY BORISENKO|"Il Naso"|Alejo Perez|Dmitrij Šostakovič|Opera di Roma|Peter Stein|Terzo domestico/quarto poliziotto/uno speculatore
ANDRIY MASLONKIN|"Il Naso"|Alejo Perez|Dmitrij Šostakovič|Opera di Roma|Peter Stein|Un conoscente/accompagnatore
ANTONIO LOZANO MORA|"Il Naso"|Alejo Perez|Dmitrij Šostakovič|Opera di Roma|Ottavo uomo/primo nuovo venuto|Peter Stein
BAURZHAN ANDERZHANOV|"Il Naso"|Alejo Perez|Dmitrij Šostakovič|Opera di Roma|Peter Stein|Quarto domestico/sesto poliziotto
WOOKYUNG KIM|"Salome"|Gabriele Ferro|Manfred Schweigkofler|Narraboth|Richard Strauss|Teatro San Carlo di Napoli
ANTONIO MEZZASALMA|"Salome"|Ein Sklave|Gabriele Ferro|Manfred Schweigkofler|Richard Strauss|Teatro San Carlo di Napoli
JAVID SAMADOV|"Salome"|"Tristan und Isolde"|-|Ein Cappadocier|Gabriele Ferro|Manfred Schweigkofler|Marcus Bosch|Melot|Monique Wagemakers|Richard Strauss|Teatro Comunale "Pavarotti" di Modena|Teatro San Carlo di Napoli
JURGITA ADAMONYTE|"Salome"|Ein Page der Herodia|Gabriele Ferro|Manfred Schweigkofler|Richard Strauss|Teatro San Carlo di Napoli
DMITRY BELOSELSKY|"Nabucodonosor"|Giuseppe Verdi|Jean-paul Scarpitta|Riccardo Muti|Roma, Teatro dell'Opera|Zaccaria
CSILLA BOROSS|"Nabucco"|"Nabucodonosor"|"Norma"|Abigaille|Antoine Selva|Gianluca Martinenghi|Giuseppe Verdi|Jean-paul Scarpitta|Jossi Wieler|Norma, druidessa, sua figlia|Pisa, Teatro Verdi|Riccardo Muti|Roma, Teatro dell'Opera|Teatro Massimo di Palermo|Vincenzo Bellini|Will Humburg
IRINA KRYAKIDOU|"Don Giovanni"|-|Antonello Manacorda|Damiano Michieletto|Damiano Michieletto,Luca Scarzella|Il ritorno di "Don Giovanni"|Teatro La Fenice|Venezia, Teatro La Fenice|Wolfgang Amadeus Mozart|Zerlina|Zerlina,
MICHAEL ALFONSI|"Werther"|Bruhlmann|Jesùs Lopez-cobos|Jules Massenet|Opera di Roma|Willy Decker
MARC BERNARD|"Werther"|Jesùs Lopez-cobos|Jules Massenet|Le Bailli|Opera di Roma|Willy Decker
ANTONIO CORIANÒ|"La Traviata"|"Macbeth"|Daniele Gatti|Dmitri Tcherniakov|Firenze, Teatro della Pergola|Gastone, Visconte di Letorières|Giuseppe Verdi|Graham Vick|James Conlon|Malcolm|Teatro alla Scala di Milano
VALENTINA DI COLA|"Il Naso"|Alejo Perez|Dmitrij Šostakovič|Opera di Roma|Peter Stein|Una vecchia dama nobile
EVA VOGEL|"Die Walküre"|"Il flauto magico"|-|Christian Arming|Dritte Dame|Graham Vick|Grimgerde|Pietari Inkinen|Roberto Andò|Teatro Massimo di Palermo|Teatro Regio
KIRIL MANOLOV|"Falstaff"|Cristina Mazzavillani Muti|Giuseppe Verdi|Nicola Paszkowski|Reggio Emilia, Teatro Valli|Sir John Falstaff|Teatro delle Muse di Ancona
GIOVANNI SEBASTIANO SALA|"Don Giovanni"|"Falstaff"|Cristina Mazzavillani Muti|Don Ottavio|Fenton|Giuseppe Verdi|Graham Vick|José Luis Gomez-rios|Nicola Paszkowski|Teatro Sociale di Como|Teatro delle Muse di Ancona|Wolfgang Amadeus Mozart
EMMA ORSINI|"Tosca"|Donato Renzetti|Giacomo Puccini|Giulio Ciabatti|Il pastorello|Trieste, Teatro Verdi
GIUSEPPE SCARICO|"La Traviata"|Ferzan Ozpetek|Giuseppe Verdi|Napoli, Teatro di San Carlo|Nello Santi|Un commissionario
FERNANDO PIQUERAS|"La Traviata"|Ferzan Ozpetek|Giuseppe Verdi|Il barone Douphol|Napoli, Teatro di San Carlo|Nello Santi
VLADIMIR REUTOV|"Aida"|"Benvenuto Cellini" di Hector Berlioz|"Il Naso"|"La Traviata"|"Simon Boccanegra"|"Turandot"|-|Alejo Perez|Alfonso Antoniozzi|Bologna, Teatro Comunale|Cabaretier|Dmitrij Šostakovič|Gastone de Letorieres|Giacomo Puccini|Giuseppe Verdi|Hector Berlioz|Il Portiere/secondo poliziotto/primo uomo/quinto poliziotto/secondo uomo|Il principe di Persia|Ivo Lipanović|Lorenzo Maria Mucci|Matteo Beltrami|Mercedes Martini|Michele Mariotti|Novara, Teatro Coccia|Opera di Roma|Peter Stein|Roberto Abbado|San Galgano|Teatro Verdi di Pisa|Teatro dell'Opera di Roma|Terry Gilliam|Un Messaggero|Un capitano dei balestrieri
ANN-BETH SOLVANG|"Les contes d'Hoffmann"|-|Damiano Michieletto|Giacomo Puccini|Il "Trittico" secondo Michieletto|Jacques Offenbach|La suora zelatrice|Rani Calderon|Theater an der Wien|Une voix|William Friedkin
ELENA GALITSKAYA|"Il Naso"|Alejo Perez|Dmitrij Šostakovič|Opera di Roma|Peter Stein|Sua figlia
CHIARA PIERETTI|"Il Naso"|"Il Trittico" di Giacomo Puccini|"La Traviata"|"La rondine"|Alejo Perez|Annina|Damiano Michieletto|Daniele Rustioni|Dmitrij Šostakovič|Giacomo Puccini|Gino Zampieri|Giuseppe Verdi|Jader Bignamini|La venditrice di ciambelle|Lisette|Massimiliano Stefanelli|Modena, Teatro Comunale|Opera di Roma|Peter Stein|Roma, Teatro dell'Opera|Sofia Coppola|Suor Dolcina/ prima conversa
ILHAM NAZAROV|"Il Naso"|Alejo Perez|Dmitrij Šostakovič|Opera di Roma|Peter Stein|Terzo conoscente di Kovalĕv
MAURIZIO ROSSI|"Il Naso"|Alejo Perez|Dmitrij Šostakovič|Due Dandies|Opera di Roma|Peter Stein
LIDIYA LIBERMAN|"Il Naso"|Alejo Perez|Dmitrij Šostakovič|Opera di Roma|Peter Stein|Un’accompagnatrice
GRAZIANO DALLAVALLE|"Benvenuto Cellini" di Hector Berlioz|"Falstaff"|"La Traviata"|"La vedova allegra"|"Roméo et Juliette"|-|Andrea Sanguineti|Bernardino|Charles Gounod|Cristina Mazzavillani Muti|Giuseppe Verdi|Grégorio|Hector Berlioz|Il Dottor Grenvil|Jader Bignamini|Manfred Schweigkofler|Modena, Teatro Comunale|Nicola Berloffa|Nicola Paszkowski|Piacenza, Teatro Municipale|Pistola|Reggio Emilia, Teatro Valli|Roberto Abbado|Roma, Teatro dell'Opera|Roul de St. Brioche|Sofia Coppola|Teatro dell'Opera di Roma|Teatro delle Muse di Ancona|Terry Gilliam|Yves Abel
THOMAS FORDE|"Il Naso"|Alejo Perez|Dmitrij Šostakovič|Il poliziotto del giardino d’estate|Opera di Roma|Peter Stein
YASUSHI WATANABE|"Don Pasquale"|"L'Olimpiade"|Bologna, Teatro Comunale|Clistene|Ernesto|Gaetano Donizetti|Gianni Marras|Giuseppe La Malfa|Josef Mysliveček|Ludek Golàt|Oliver Von Dohànyi
ANTONIO DE LISIO|"La Traviata"|Ferzan Ozpetek|Giuseppe Verdi|Napoli, Teatro di San Carlo|Nello Santi|Un domestico
ALESSIO DE COSMO|"Tosca"|Alberto Veronesi|Bari, Teatro Petruzzelli|Giacomo Puccini|Michele Mirabella|Un pastore
GIOVANNI CETO|"Tosca"|Alberto Veronesi|Bari, Teatro Petruzzelli|Giacomo Puccini|Michele Mirabella|Un carceriere
ANNEMARIE KREMER|"Salome"|-|Gabriele Ferro|Giuseppe Verdi|Luisa|Manfred Schweigkofler|Markus Dietz|Richard Strauss|Salome|Teatro San Carlo di Napoli|Thomas Søndergård
ANTONIO POLI|"Die Zauberflöte"|"Il Trittico" di Giacomo Puccini|"L'elisir d'amore"|"La Traviata"|"Macbeth"|"Nabucodonosor"|-|Alfredo Germont|Antonello Manacorda|Damiano Michieletto|Daniel Harding|Daniele Abbado|Daniele Rustioni|Diego Matheuz|Don Ottavio,|Due amanti|Fenton|Francesco Lanzillotta|Gaetano Donizetti|Giacomo Puccini|Giuseppe Verdi|Il ritorno di "Don Giovanni"|Ismaele|Jader Bignamini|Jean-paul Scarpitta|Macduff|Nemorino, coltivatore, giovane semplice|Peter Stein|Petruzzelli di Bari|Riccardo Muti|Rinuccio|Robert Carsen|Roland B|Roma, Teatro dell'Opera|Saverio Marconi|Sofia Coppola|Tamino|Teatro della Fortuna di Fano|Venezia, Teatro La Fenice|Wolfgang Amadeus Mozart
ARUTJUN KOTCHINIAN|"Don Quichotte"|"Čerevički"|Cagliari, Teatro Lirico|Daniel Cohen,Marco Faelli|Don Quichotte|Donato Renzetti|Federico Tiezzi|Jules Massenet|Pëtr Il’ič Čajkovskij|Teatro Lirico di Cagliari|Yuri Alexandrov|Čub
SIMEONE LATINI|"Don Quichotte"|Daniel Cohen,Marco Faelli|Federico Tiezzi|Il capo dei banditi|Jules Massenet|Teatro Lirico di Cagliari
FRANCESCO MUSINU|"Il Naso"|"Il Trittico" di Giacomo Puccini|"La Traviata"|"La battaglia di Legnano"|"Macbeth"|"Rigoletto"|"Roméo et Juliette"|"Salome"|-|Alcindoro|Alejo Perez|Andrea Battistoni|Andrea Cigni|Boris Brott|Brescia, Teatro Grande|Calixto Bieito|Carlo Montanaro|Charles Gounod|Conte di Ceprano|Damiano Michieletto|Daniele Rustioni|Dmitrij Šostakovič|Dottor Grenvil|Fabio Banfo|Ferzan Ozpetek|Gabriele Ferro|Georges Bizet|Giacomo Puccini|Giampaolo Maria Bisanti|Gianluigi Gelmetti|Gilbert Deflò|Giuseppe Verdi|Henning Brockhaus|Il conte di Ceprano|Il dottor Grenvil|Il primo console di Milano|James Conlon|La liberté!» Carmen al Regio di Torino|Liliana Cavani|Lorenzo Amato|Manfred Schweigkofler|Michael Balke|Napoli, Teatro di San Carlo|Nello Santi|Opera di Roma|Paris|Patrick Fournillier|Peter Stein|Richard Strauss|Roma, Teatro dell'Opera|Ruggero Cappuccio|Saverio Santoliquido,Yutaka Sado|Scala|Ser Amantio di Nicolao|Sesto domestico/Padre|Teatro San Carlo di Napoli|Teatro Verdi di Trieste|Teatro alla Scala|Torino, Teatro Regio|Trieste, Teatro Verdi|Un Sicario|Zuniga|Zwei Soldaten|«Et surtout la chose enivrante
PAVEL DANILUK|"Il Naso"|"Jenůfa"|"Parsifal"|-|Alejo Perez|Claus Guth|Dmitri Tcherniakov|Dmitrij Šostakovič|Fabio Luisi|Il giudice del villaggio|Leoš Janáček|Mikko Franck|Opera di Roma|Peter Stein|Titurel|Un conoscente di Kovalĕv|Zurigo,Opernhaus|Zürich, Opernhaus
EZGI KUTLU|"Il Trionfo del Tempo e del Disinganno"|"Maria Stuarda"|"Nabucodonosor"|-|Calixto Bieito|Elisabetta, regina d'Inghilterra|Fenena|Gaetano Donizetti|Georg Frideric Handel|Giuseppe Verdi|Jean-paul Scarpitta|Marc Soustrot|Piacere|Riccardo Muti|Roma, Teatro dell'Opera|Staatsoper Stuttgart|Sébastien Rouland
DIEGO MANTO|-|Cristina Mazzavillani Muti|E Cristina disse|Giuseppe Verdi|Un vecchio zingaro|“ Facciamo Trovatore… ”
PIETRO PICONE|"Fidelio"|"Il Naso"|"La Traviata"|"La battaglia di Legnano"|"Madama Butterfly"|"Otello"|"Werther"|-|Alejo Perez|Arena Sferisterio di Macerata|Dmitrij Šostakovič|Erster Gefangener|Gastone|Giacomo Puccini|Giorgio Ferrara|Giuseppe Verdi|Henning Brockhaus|Il Principe Yamadori|Jesùs Lopez-cobos|Jules Massenet|Ludwig Van Beethoven|Opera di Firenze|Opera di Roma|Palermo|Peter Stein|Pier’alli|Pinchas Steinberg|Renato Palumbo|Roderigo|Roma,Teatro dell'Opera|Ruggero Cappuccio|Schmidt|Settimo poliziotto/terzo uomo|Un araldo|Willy Decker|Zubin Mehta
SILVIA REGAZZO|"Die Zauberflöte"|"La gazza ladra"|"Roméo et Juliette"|"The rake's progress"|Andrea Cigni|Antonello Manacorda|Brescia, Teatro Grande|Charles Gounod|Damiano Michieletto|Diego Matheuz|Gioachino Rossini|Giovanni Battista Rigon|Igor Stravinskij|Michael Balke|Mother Goose|Pippo|Stephano|Teatro La Fenice di Venezia|Terza dama|Venezia, Teatro La Fenice|Verona|Wolfgang Amadeus Mozart
SALTAN AKHMETOVA|"L'Olimpiade"|Alcandro|Bologna, Teatro Comunale|Josef Mysliveček|Ludek Golàt|Oliver Von Dohànyi
TATIA JIBLADZE|"L'Olimpiade"|Bologna, Teatro Comunale|Josef Mysliveček|Licida|Ludek Golàt|Oliver Von Dohànyi
MATTEO FALCIER|"Benvenuto Cellini" di Hector Berlioz|"Falstaff"|"Il matrimonio segreto"|"La Bohéme"|"La Cecchina, ossia la buona figliuola"|"Les contes d'Hoffmann"|"Turandot"|"Zaira"|Andres, Cochenille, Frantz, Pittichinaccio|Bardolfo|Bergamo, Teatro Donizetti|Castiglione|Christian Capocaccia|Cristina Mazzavillani Muti|Domenico Cimarosa|Francesco|Francesco Bellotto|Frédéric Roels|Giacomo Puccini|Giacomo Sagripanti|Giuseppe Verdi|Hector Berlioz|Il Marchese della Conchiglia|Italo Nunziata|Jacques Offenbach|Julian Kovatchev|Matteo Beltrami|Mercedes Martini|Niccolò Piccinni|Nicola Paszkowski|Novara, Teatro Coccia|Paolino|Pong|Reggio Emilia, Teatro Valli|Roberto Abbado|Rodolfo|Rosetta Cucchi|Stefano Montanari|Teatro Fraschini di Pavia|Teatro del Giglio di Lucca|Teatro dell'Opera di Roma|Teatro delle Muse di Ancona|Terry Gilliam|Vincenzo Bellini|XXXVIII° Festival della Valle d'Itria
GIUSEPPE VALENTINO|"La Traviata"|Ferzan Ozpetek|Giuseppe|Giuseppe Verdi|Michele Mariotti|Teatro San Carlo di Napoli
FEDERICO LEPRE|"Die Zauberflöte"|"La Traviata"|Antonello Manacorda|Damiano Michieletto|Ferzan Ozpetek|Gastone|Giuseppe Verdi|Michele Mariotti|Primo armigero/secondo sacerdote|Teatro San Carlo di Napoli|Venezia, Teatro La Fenice|Wolfgang Amadeus Mozart
CARMINE DURANTE|"La Traviata"|Ferzan Ozpetek|Giuseppe Verdi|Michele Mariotti|Teatro San Carlo di Napoli|Un commissionario
SERGIO VALENTINO|"La Traviata"|Ferzan Ozpetek|Giuseppe Verdi|Michele Mariotti|Teatro San Carlo di Napoli|Un domestico
BIAGIO PIZZUTI|"Don Giovanni"|"L'elisir d'amore"|"L'elisir d'amore" a Palazzo Pitti|"Roméo et Juliette"|Alessandro D'agostini|Andrea Battistoni|Arnaud Bernard|Belcore|Betto di Signa|Brescia, Teatro Grande|Charles Gounod|Damiano Michieletto|Dulcamara|Fabio Luisi|Firenze, stagione lirica estiva dell'Opera|Gaetano Donizetti|Genova, Teatro Carlo Felice|Giacomo Puccini|Grégorio|Il "Trittico" secondo Michieletto|Jean-louis Grinda|Lorenzo Amato|Masetto|Palermo, Teatro Massimo|Pier Francesco Maestrini|Rani Calderon|Stefano Ranzani|Theater an der Wien|Wolfgang Amadeus Mozart
MATIAS TOSI|"La Bohéme"|Cristina Mazzavillani Muti|Giacomo Puccini|Marcello|Nicola Paszkowski|Novara, Teatro Coccia
DANIEL GIULIANINI|"La Bohéme"|Cristina Mazzavillani Muti|Giacomo Puccini|Nicola Paszkowski|Novara, Teatro Coccia|Schaunard
CARLO GAMBARO|"La Bohéme"|Cristina Mazzavillani Muti|Giacomo Puccini|Mimi|Nicola Paszkowski|Novara, Teatro Coccia
MAURIZIO LO PICCOLO|"Giovanna d’Arco"|"Il mondo alla rovescia"|"Otello"|Antonio Saliero|Bruno Bartoletti|Damiano Michieletto|Federico Maria Sardelli|Festival Verdi 2008|Gabriele Lavia|Giacomo Puccini|Giuseppe Verdi|Henning Brockhaus|Il "Trittico" secondo Michieletto|Il Conte|Il Talpa|Marco Gandini|Montano|Palermo|Rani Calderon|Renato Palumbo|Simone|Talbot|Theater an der Wien|Verona, Teatro Filarmonico
ADRIANA DI PAOLA|"Die Zauberflöte"|"L'incoronazione di Poppea"|"La forza del destino"|-|Arnalta|Claudio Monteverdi|Curra|Daniele Abbado|Gianluigi Gelmetti|Milano, Teatro alla Scala|Parma, Teatro Regio|Petruzzelli di Bari|Rinaldo Alessandrini|Robert Wilson|Roland B|Stefano Poda|Terza dama|Wolfgang Amadeus Mozart
ERIKA PAGAN|"Il Naso"|"L'Elisir d'amore"|Alejo Perez|Bruno Campanella|Dmitrij Šostakovič|Gaetano Donizetti|Giannetta|La Madre/Una dama elegante|Opera di Roma|Peter Stein|Ruggero Cappuccio
RICCARDO COLTELLACCI|"La Traviata"|"Madama Butterfly"|Commissionario|Giacomo Puccini|Giorgio Ferrara|Giuseppe Verdi|Il Commissario Imperiale|Jader Bignamini|Pinchas Steinberg|Roma, Teatro dell'Opera|Roma,Teatro dell'Opera|Sofia Coppola
tag|Giacomo Puccini|62
tag|Giuseppe Verdi|60
tag|Damiano Michieletto|54
tag|Peter Stein|44
tag|Opera di Roma|41
tag|Roma, Teatro dell'Opera|36
tag|"La Traviata"|34
tag|Dmitrij Šostakovič|32
tag|Alejo Perez|32
tag|"Il Naso"|32
tag|Wolfgang Amadeus Mozart|32
tag|Daniele Rustioni|28
tag|Petruzzelli di Bari|27
tag|"Die Zauberflöte"|26
tag|"Il Trittico" di Giacomo Puccini|25
tag|Gaetano Donizetti|24
tag|Rani Calderon|22
tag|Il "Trittico" secondo Michieletto|22
tag|Theater an der Wien|22
tag|Daniele Abbado|21
tag|Cristina Mazzavillani Muti|18
tag|Daniele Gatti|18
tag|Roland B|18
tag|Venezia, Teatro La Fenice|16
tag|Nicola Paszkowski|15
tag|Teatro San Carlo di Napoli|15
tag|Jader Bignamini|15
tag|"Falstaff"|15
tag|Teatro alla Scala|13
tag|Antonello Manacorda|13
tag|Manfred Schweigkofler|12
tag|"Il cappello di paglia di Firenze"|12
tag|Reggio Emilia, Teatro Valli|11
tag|Giuseppe La Malfa|11
tag|Elena Barbalich|11
tag|Sofia Coppola|11
