MERT SÜNGÜ|"Tancredi"|Argirio|Francesco Cilluffo|Francesco Frongia|Gioachino Rossini|Pavia, Teatro Fraschini
SOFIA MCHEDLISHVILI|"Tancredi"|Amenaide|Francesco Cilluffo|Francesco Frongia|Gioachino Rossini|Pavia, Teatro Fraschini
MICHAELA KAPUSTOVÁ|"Příhody lišky Bystroušky" (La piccola volpe astuta)|-|Jan Latham-koening|La volpe maschio Zlatohřbítek|Robert Carsen|Torino, Teatro Regio
LUCIE SILKENOVÁ|"Příhody lišky Bystroušky" (La piccola volpe astuta)|-|Jan Latham-koening|La volpe Bystrouška|Robert Carsen|Torino, Teatro Regio
LENKA ŠMÍDOVÁ|"Příhody lišky Bystroušky" (La piccola volpe astuta)|-|Jan Latham-koening|La signora Pásková e il picchio|Robert Carsen|Torino, Teatro Regio
MARTINA PELUSI|"Příhody lišky Bystroušky" (La piccola volpe astuta)|-|Jan Latham-koening|Pepík|Robert Carsen|Torino, Teatro Regio
MARTINA BARONI|"Příhody lišky Bystroušky" (La piccola volpe astuta)|-|Frantík|Jan Latham-koening|Robert Carsen|Torino, Teatro Regio
FUMITOSHI MIYAMOTO*|"Macbeth"|-|Giancarlo Cobelli|Giuseppe Verdi|Medico/Domestico|Modena, Teatro Comunale
SHOUSHIK BARSOUMIAN*|"Macbeth"|-|Dama di Lady Macbeth|Giancarlo Cobelli|Giuseppe Verdi|Modena, Teatro Comunale
ANGELO VILLARI|"Adriana Lecouvreur"|"Aida"|"Il Corsaro"|"Lucia di Lammermoor"|"Madama Butterfly"|-|Carlo Goldstein|Carlo Montanaro|Denis Krief|Elisabetta Marini|F.B. Pinkerton|Fabio Ceresa|Festival Verdi 2008|Francesco Cilea|Francesco Lanzillotta|Gaetano Donizetti|Giacomo Puccini|Giulio Ciabatti|Giuseppe Finzi|Giuseppe Verdi|Ivan Stefanutti|Lamberto Pugelli|Maurizio|Normanno|Parma, Teatro Regio|Pinkerton|Regio di Parma|Stefano Ranzani|Teatro Massimo di Palermo|Teatro Petruzzelli di Bari|Teatro Sociale di Como|Un eunuco/uno schiavo|Un messaggero
SVATOPLUK SEM|"Příhody lišky Bystroušky" (La piccola volpe astuta)|-|Il guardiacaccia e la zanzara|Jan Latham-koening|Robert Carsen|Torino, Teatro Regio
MARIO CASSI|"Così fan tutte"|"Don Pasquale"|"Gemma di Vergy"|"I due Figaro"|"L'Italiana in Algeri"|"L'elisir d'amore"|"La vedova allegra"|"Lucia di Lammermoor"|"Madama Butterfly"|"Pagliacci/Cavalleria rusticana"|"Rigoletto"|-|Antonio Albanese|Bari, Teatro Petruzzelli|Belcore|Bergamo, Teatro Donizetti|Buenos Aires|Christoph Campestrini|Conte di Vergy|Damiano Michieletto|Daniel Harding|Davide Livermore|Dottor Malatesta|Emilio Sagi|Fabio Ceresa|Figaro|Franz Lehár|Gaetano Donizetti|Giacomo Puccini|Gilbert Deflo|Gioachino Rossini|Giuseppe Finzi|Giuseppe Verdi|Guglielmo|Gustavo Dudamel|Henning Borckhaus|Henning Brockhaus,Valentina Escobar|Hugo De Ana|Il conte Danilo Danilowitsch|Josè Ramon Encinar|Laurent Gerber|Lord Enrico Ashton|Lorenzo Fratini,Giuseppe La Malfa|Madrid, Teatro Real|Mario Martone|Marullo|Milano, Teatro alla Scala|Omer Meir Wellber|Parma, Teatro Regio|Piacenza, Teatro Municipale|Pietro Mascagni|ROF|Riccardo Canessa|Riccardo Muti|Riccardo Muti dirige "I due Figaro"|Roberto Abbado|Roberto Rizzi Brignoli|Rosetta Cucchi|Saverio Mercadante|Sharpless|Silvio|Stefano Ranzani|Taddeo|Teatro Massimo di Palermo|Teatro Petruzzelli di Bari|Teatro Regio di Torino|Teatro San Carlo di Napoli|Teatro del Maggio Musicale Fiorentino|Verona, Teatro Filarmonico|Wolfgang Amadeus Mozart
SEBASTIÁN COVARRUBIAS|Alessandro Talevi|Andriy Yurkevych|Gaetano Donizetti|Teatro Real di Madrid|Un paggio|“Roberto Devereux”
LARA LAGNI|"La Vedova allegra"|Alfred Eschwé|Federico Tiezzi|Franz Lehár|Praskowia|San Carlo di Napoli
LORELAY SOLIS|"Madama Butterfly"|"Stiffelio"|Andrea Battistoni|Dorotea|Francesco Lanzillotta|Giacomo Puccini|Giulio Ciabatti|Giuseppe Verdi|Guy Montavon|La zia|Parma, Teatro Regio|Teatro Regio di Parma
RAFFAELLA SPADACCINI|"Cavalleria rusticana" e "Pagliacci"|-|Alessio Pizzech|Modena, Teatro Comunale|Nedda|Pietro Mascagni
OZGE KALELIOGLU|"Cavalleria rusticana" e "Pagliacci"|-|Alessio Pizzech|Lola|Modena, Teatro Comunale|Pietro Mascagni
GIULIO PELLIGRA|"Cavalleria rusticana" e "Pagliacci"|"Der König Kandaules"|"Don Carlo"|"Il cappello di paglia di Firenze"|"Il viaggio a Reims"|"Lucia di Lammermoor"|"Maometto II"|"Otello"|"Čerevički"|-|Alessio Pizzech|Alexander Zemlinsky|Asher Fisch|Beppe|Cagliari, Teatro Lirico|Cassio|Como, Teatro Sociale|Donato Renzetti|Elena Barbalich|Fabrizio Ventura|Fadinard|Gaetano Donizetti|Giampaolo Bisanti|Giampiero Solari|Gilbert Deflo|Gioacchino Rossini|Gioachino Rossini|Giuseppe La Malfa|Giuseppe Verdi|Il Conte di Lerma|Il cavalier Belfiore|Il maestro di scuola|Jonathan Webb|Joseph Franconi Lee|Lord Arturo Bucklaw|Manfred Schweigkofler|Matteo Beltrami|Modena, Teatro Comunale|Novara, Teatro Coccia|Opera di Roma|Palermo, Teatro Massimo|Paolo Erisso|Peppe|Petruzzelli di Bari|Pier Luigi Pizzi|Pietro Mascagni|Pisa, Teatro Verdi|Pëtr Il’ič Čajkovskij|Roberto Abbado|Sebas|Stefano De Luca|Stefano Ranzani|Teatro Massimo di Palermo|Yuri Alexandrov
ANTONIO DELLA SANTA|"Cavalleria rusticana" e "Pagliacci"|"La Bohème"|-|Alessio Pizzech|Contadini|Due contadini|Elio Boncompagni|Giacomo Puccini|Jonathan Webb|Lucca, Teatro del Giglio|Marco Gandini|Modena, Teatro Comunale|Pietro Mascagni|Pisa, Teatro Verdi|Sergente dei doganieri
NICOLA VOCATURO|"Cavalleria rusticana" e "Pagliacci"|-|Alessio Pizzech|Due contadini|Modena, Teatro Comunale|Pietro Mascagni
ANOOSHAH GOLESORKHI|"Cavalleria rusticana" e "Pagliacci"|-|Alessio Pizzech|Alfio|Modena, Teatro Comunale|Pietro Mascagni|Tono
SYLVIA SCHWARTZ|-|Gretel|Laurent Pelly|Paul Daniel|Teatro Real di Madrid|“Hänsel und Gretel”
ELENA COPONS|-|Il nano sabbioso|Laurent Pelly|Paul Daniel|Teatro Real di Madrid|“Hänsel und Gretel”
DIANE MONTAGUE|-|Gertrud|Laurent Pelly|Paul Daniel|Teatro Real di Madrid|“Hänsel und Gretel”
MERTU SURGU|"Il barbiere di Siviglia"|Davide Livermore|Donato Renzetti|Gioachino Rossini|Il conte di Almaviva|Teatro dell'Opera di Roma
CHRISTIAN COLLIA|"La vedova allegra"|"Mirandolina" di Bohuslav Martinů|-|Antonio Pirolli|Camille de Petruzzel|Camille de Rossillon|Fabio Sparvoli|Franz Lehár|Gianmaria Aliverta|Jesi, Teatro Pergolesi|John Axelrod|Lucca, Teatro del Giglio|Nicola Paszkowski|Servitore del cavaliere|Venezia, Teatro La fenice|Vittorio Sgarbi
MARIA SALVINI|Alessio Pizzech|Il dittico "Zanetto/Cavalleria Rusticana"|Livorno|Lola|Pietro Mascagni|Valerio Galli
CRISTINA MARTUFI|Alessio Pizzech|Il dittico "Zanetto/Cavalleria Rusticana"|Livorno|Pietro Mascagni|Silvia|Valerio Galli
FRANCESCA SASSU|"Boris Godunov"|"Così fan tutte"|"Die Zauberflöte" (Il Flauto Magico)|"Il viaggio a Reims"|"La donna serpente" di Alfredo Casella|"La rondine"|"Turandot"|-|Alfredo Casella|Arturo Cirillo|Cagliari|Christopher Franklin|Comunale di Sassari|Daniele Callegari|Eimuntas Nekrosius|Eliahu Inbal|Farzana e La corifea|Fiordiligi|Francesco Micheli|Giacomo Puccini|Giampiero Solari|Gianandrea Noseda|Gino Zampieri|Gioacchino Rossini|Jacopo Spirei|Ksenija|Liù|Madama Cortese|Magda|Massimiliano Stefanelli|Matteo Beltrami|Mercedes Martini|Modena, Teatro Comunale|Musetta|Novara, Teatro Coccia|Papagena|Roberto Andò|Torino, Teatro Regio|Venezia, Teatro La Fenice|Wolfgang Amadeus Mozart
MICHELE PATTI|"Rigoletto"|Alessio Pizzech|Busseto, Teatro Verdi|Fabrizio Cassi|Giuseppe Verdi|Marullo
STEFANO MEO|"Rigoletto"|Alessio Pizzech|Busseto, Teatro Verdi|Fabrizio Cassi|Giuseppe Verdi|Rigoletto
MARIANNA MENNITTI|"Rigoletto"|Alessio Pizzech|Busseto, Teatro Verdi|Fabrizio Cassi|Giuseppe Verdi|La Contessa di Ceprano/Un paggio
TERESA DI BARI|"La vedova allegra"|Antonio Pirolli|Franz Lehár|Jesi, Teatro Pergolesi|Sylviane|Vittorio Sgarbi
GENNARO CANAVACCIUOLO|"La vedova allegra"|Antonio Pirolli|Franz Lehár|Jesi, Teatro Pergolesi|Njegus|Vittorio Sgarbi
GIANLUCA MARGHERI|"Adriana Lecouvreur"|"Ernani"|"I puritani"|"Il Barbiere di Siviglia"|"Il viaggio a Reims"|"La Cenerentola"|"La Traviata"|"La scala di seta"|"Macbeth"|"Madama Butterfly"|"Pagliacci", "Gianni Schicchi"|"Roméo et Juliette"|-|Alidoro|Andrea Battistoni|Andrea Cigni|Antonio Pirolli|Arnaud Bernard|Barone Douphol|Bepi Morassi|Betto di Signa|Blansac|Brescia, Teatro Grande|Charles Gounod|Comunale di Sassari|Don Alvaro|Fabio Ceresa|Federico Grazzini|Fiorello|Firenze|Firenze, Teatro della Pergola|Francesco Cilea|Francesco Ivan Ciampa|Francesco Lanzillotta|Francesco Pasqualetti|Gabriele Ferro|Giacomo Puccini|Giampiero Solari|Gioacchino Rossini|Gioachino Rossini|Giorgio Barberio Corsetti|Giuseppe Verdi|Graham Vick|Henning Brockhaus|Il Principe Yamadori|Il Principe di Bouillon|Ivan Stefanutti|Jago|James Conlon|José Carlos Plaza|Lord Gualtiero Valton, governatore puritano|Lorenzo Mariani|Matteo Beltrami|Matteo Beltrami,Luca Sirigu|Novara, Teatro Coccia|Opera di Firenze|Paris|Parma, Teatro Regio|Roma, Terme di Caracalla|Sassari, Teatro Comunale|Scienza e Belcanto all'Opera di Firenze|Sergio Alapont|Stefano Montanari|Stefano Trespidi|Teatro Comunale di Sassari|Teatro Massimo di Palermo|Trieste, Teatro Verdi|Un "Barbiere" sottotono|Un medico|Vincenzo Bellini|“I Puritani”
CLEMENTE ANTONIO DALIOTTI|"Così fan tutte"|"Il Campiello"|"L'Italiana in Algeri"|-|Antonino Manuli|Bologna, Teatro Comunale|Comunale di Sassari|Ermanno Wolf-ferrari|Francesco Cilluffo|Francesco Esposito|Gioachino Rossini|Gugliemo|Haly|Il cavalier Astolfi|Jacopo Spirei|Leo Muscato|Massimo "Bellini" di Catania|Michele Mirabella|Paolo Olmi|Taddeo|Teatro dell'Opera di Firenze|Wolfgang Amadeus Mozart
FRANCISCO BRITO|"Il signor Bruschino"|"Il viaggio a Reims"|"L'Italiana in Algeri"|"La scala di seta"|"Zelmira"|Commissario|Damiano Michieletto|Daniele Rustioni|Dorvil|Eacide|Ferrara, Teatro Comunale|Francesco Ommassini|Giampiero Solari|Gioacchino Rossini|Gioachino Rossini|Giorgio Barberio Corsetti|Giuseppe Emilian,Giuseppe Emiliani|Il conte di Libenskof|Lindoro|Matteo Beltrami|Novara, Teatro Coccia|OperaLombardia, Teatro Ponchielli di Cremona|Roberto Abbado|Rossini Opera Festival|Rossini Opera festival 2009|Teatro Sotterraneo
JOCHEN KUPFER|"Tristan und Isolde"|-|Kurwenal|Marcus Bosch|Monique Wagemakers|Teatro Comunale "Pavarotti" di Modena
MIKLÓS SEBESTYÉN|-|Emilio Sagi|Evelino Pidò|Lord Gualtiero Valton|Teatro Real di Madrid|“I Puritani”
CARLOS CARDOSO|"Rigoletto"|-|Alessio Pizzech|Busseto, Teatro Verdi|Fabrizio Cassi|Giuseppe Verdi|Il Duca di Mantova|Il conte di Lerma|Milano, Teatro alla Scala|Stéphane Braunschweig|“Don Carlo”
LIDIA LUNETTA|"Nabucco"|Anna|Carlo Antonio De Lucia|Francesco Ledda|Giuseppe Verdi|Luglio Musicale Trapanese
ATALA SCHÖCK|"Hänsel und Gretel"|Engelbert Humperdinck|Gertrud|Pinchas Steinberg|Teatro Regio di Torino|Vittorio Borrelli
MIHAIL DOGOTARI**|"La Cenerentola"|Alidoro|Brescia, Teatro Grande|Giacomo Sagripanti|Gioachino Rossini|Rosetta Cucchi
ROSWITHA CHRISTINA MÜLLER|"Tristan und Isolde"|-|Brangäne|Marcus Bosch|Monique Wagemakers|Teatro Comunale "Pavarotti" di Modena
PATRIZIA CIGNA|"Il matrimonio segreto"|"Il mondo alla rovescia"|"La traviata"|"La voix humaine" e "Suor Angelica"|-|Andrea De Rosa|Antonio Saliero|Carolina|Casciana Terme|Domenico Cimarosa|Emiliana Paoli|Ermanno Wolf-ferrari|Federico Maria Sardelli|Giacomo Puccini,Francis Poulenc|Giuseppe Verdi|Gnese|La Colonnella|Marco Gandini|Matteo Beltrami|Opera di Firenze|Paolo Trevisi|Renato Bonajuto|Roberto Zarpellon|Stefano Romani|Suor Genovieffa|Verona, Teatro Filarmonico|Violetta Valéry|Xu Zhong
ELEONORA DE LA PENA|"Il Barbiere di Siviglia"|"Il barbiere di Siviglia"|Berta|Davide Livermore|Donato Renzetti|Gioachino Rossini|Lorenzo Mariani|Roma, Terme di Caracalla|Stefano Montanari|Teatro dell'Opera di Roma
RENE’ BARBERA|"Il Barbiere di Siviglia"|Gioachino Rossini|Il Conte di Almaviva|Lorenzo Mariani|Roma, Terme di Caracalla|Stefano Montanari
LAURA POLLICE|"Turandot"|Giacomo Puccini|Matteo Beltrami|Mercedes Martini|Novara, Teatro Coccia|Prima ancella
GIOVANNI LA COMMARE|-|Giacomo Puccini|Il sergente degli arcieri|Palermo|Roberto Gianola|“Manon Lescaut” per l’Orchestra Sinfonica Siciliana
GIUSEPPE PELLINGRA|-|Gennaro Iovine|Giacomo Puccini|Il comandante di marina|Lucca, Teatro del Giglio|Nino Rota|Palermo|Roberto Gianola|“Manon Lescaut” per l’Orchestra Sinfonica Siciliana|“Napoli milionaria”
FRANCESCO PARRINO|"Norma"|-|Edmondo|Flavio, romano amico di Pollione|Giacomo Puccini|Jossi Wieler|Palermo|Roberto Gianola|Teatro Massimo di Palermo|Vincenzo Bellini|Will Humburg|“Manon Lescaut” per l’Orchestra Sinfonica Siciliana
GIOVANNI DI MARE|-|Giacomo Puccini|L’oste|Palermo|Roberto Gianola|“Manon Lescaut” per l’Orchestra Sinfonica Siciliana
DEBORA TROÌA|-|Giacomo Puccini|Palermo|Roberto Gianola|Un musico|“Manon Lescaut” per l’Orchestra Sinfonica Siciliana
FELICE TENNERIELLO|-|Giacomo Puccini|Lescaut|Palermo|Roberto Gianola|“Manon Lescaut” per l’Orchestra Sinfonica Siciliana
ALFREDO RUSCICA|"Nabucco"|-|Abdallo|Carlo Antonio De Lucia|Francesco Ledda|Giacomo Puccini|Giuseppe Verdi|Il maestro di ballo / il lampionaio|Luglio Musicale Trapanese|Palermo|Roberto Gianola|“Manon Lescaut” per l’Orchestra Sinfonica Siciliana
ARMANDO ARIOSTINI|"La vedova allegra"|-|Antonio Pirolli|Franz Lehár|Geronte di Ravoir|Giacomo Puccini|Il barone Mirko Zeta|Jesi, Teatro Pergolesi|Palermo|Roberto Gianola|Vittorio Sgarbi|“Manon Lescaut” per l’Orchestra Sinfonica Siciliana
MARIA GAIA PELLEGRINI|"La traviata"|Annina|Casciana Terme|Giuseppe Verdi|Matteo Beltrami|Renato Bonajuto
GIAMPAOLO FRANCONI|"Il matrimonio segreto"|"La traviata"|Casciana Terme|Domenico Cimarosa|Emiliana Paoli|Gastone, Visconte di Letorières|Giuseppe Verdi|Matteo Beltrami|Paolino|Renato Bonajuto|Roberto Zarpellon
MICHELE PIERLEONI|"Il matrimonio segreto"|"La traviata"|Casciana Terme|Conte Robinson|Domenico Cimarosa|Emiliana Paoli|Giuseppe Verdi|Il Barone Douphol|Matteo Beltrami|Renato Bonajuto|Roberto Zarpellon
MASSIMILIANO GALLI|"La traviata"|Casciana Terme|Giuseppe Verdi|Il Dottor Grenvil|Matteo Beltrami|Renato Bonajuto
REGULA MÜHLEMANN|"Hänsel und Gretel"|Engelbert Humperdinck|Gretel|Pinchas Steinberg|Teatro Regio di Torino|Vittorio Borrelli
BERNADETTE MÜLLER|"Hänsel und Gretel"|Engelbert Humperdinck|Pinchas Steinberg|Taumännchen|Teatro Regio di Torino|Vittorio Borrelli
CARMELO CARUSO|"La traviata"|Casciana Terme|Giorgio Gérmont|Giuseppe Verdi|Matteo Beltrami|Renato Bonajuto
ALBERTO FONTI|"La traviata"|Casciana Terme|Giuseppe|Giuseppe Verdi|Matteo Beltrami|Renato Bonajuto
ROBERTO CRISTIANI|"La traviata"|Casciana Terme|Giuseppe Verdi|Matteo Beltrami|Renato Bonajuto|Un commissario|Un domestico di Flora
SERBAN VASILE*|"La Cenerentola"|Brescia, Teatro Grande|Dandini|Giacomo Sagripanti|Gioachino Rossini|Rosetta Cucchi
OMAR MONTANARI|"Così fan tutte"|"I due Figaro"|"Il Barbiere di Siviglia"|"Il barbiere di Siviglia"|"Il matrimonio segreto"|"L'italiana in Algeri"|"La Cenerentola"|"La gazza ladra"|"Mirandolina" di Bohuslav Martinů|"Occasione"|-|Bartolo|Bepi Morassi|Bergamo, Teatro Donizetti|Brescia, Teatro Grande|Bruno Campanella|Buenos Aires|Como, Teatro Sociale|Comunale di Sassari|Damiano Michieletto|Davide Livermore|Domenico Cimarosa|Don Alfonso|Don Bartolo|Don Magnifico|Don Parmenione|Donato Renzetti|Dottor Bartolo|Elisabetta Brusa|Emilio Sagi|Fabrizio Vingradito|Federico Grazzini|Francesco Bellotto|Giacomo Sagripanti|Gianmaria Aliverta|Gioachino Rossini|Giovanni Battista Rigon|Il "Barbiere" di Morassi|Il Conte Robinson|Il bianco s'addice|Il cavaliere di Ripafratta|Il giovane Rossini al Malibran|Italo Nunziata|Jacopo Spirei|Joan Font|John Axelrod|Julian Kovatchev|Lorenzo Mariani|Madrid, Teatro Real|Malibran|Matteo Beltrami|Opera di Firenze|Pier Francesco Maestrini|Plagio|Riccardo Muti|Riccardo Muti dirige "I due Figaro"|Roland Böer|Roma, Terme di Caracalla|Rosetta Cucchi|Saverio Mercadante|Stefano Montanari|Stefano Rabaglia|Taddeo|Teatro del Giglio di Lucca|Teatro dell'Opera di Roma|Tobia Mill, negoziante|Venezia, Teatro La fenice|Verona|Verona, Teatro Filarmonico|Wolfgang Amadeus Mozart|diciott'anni, ma non li dimostra
STEFANIA SILVESTRI|"La Cenerentola"|Brescia, Teatro Grande|Clorinda|Giacomo Sagripanti|Gioachino Rossini|Rosetta Cucchi
FEDERICA CARNEVALE|"Don Pasquale"|-|Antonio Greco|Caterina Panti Liberovici|Cesare Scarton|Francesco Bellotto|Gaetano Donizetti|Gioachino Rossini|Giovanni Battista Rigon|Isabella|Leonardo Leo|Marco Moresco|Norina|Silvio|Teatro Olimpico di Vicenza
TINA EBERHARDT|"Euryanthe"|Badisches Staatstheater di Karlsruhe|Carl Maria Von Weber|Cristoph Gedschold|Emma|Roland Aeschlimann
SARA ALLEGRETTA|"La Sonnambula"|Daniele Callegari|Giorgio Barberio Corsetti|Petruzzelli di Bari|Teresa|Vincenzo Bellini
ADRIANO GRAMIGNI|"Madama Butterfly"|Francesco Lanzillotta|Giacomo Puccini|Giulio Ciabatti|L’ufficiale del registro|Parma, Teatro Regio|Yakusidé
DIEGO ILARIUZZI|"Madama Butterfly"|Dolore|Francesco Lanzillotta|Giacomo Puccini|Giulio Ciabatti|Parma, Teatro Regio
LEONORA SOFIA|"Madama Butterfly"|Francesco Lanzillotta|Giacomo Puccini|Giulio Ciabatti|Kate Pinkerton|La madre di Cio Cio San|Parma, Teatro Regio
TAE JEONG HWANG|"Madama Butterfly"|Francesco Lanzillotta|Giacomo Puccini|Giulio Ciabatti|Il commissario imperiale|Parma, Teatro Regio
VASYL SOLODKYY|"La vedova allegra"|-|Fabio Sparvoli|Lucca, Teatro del Giglio|Nicola Paszkowski|Raoul de St-Brioche
EDITH HALLER|"Euryanthe"|Badisches Staatstheater di Karlsruhe|Carl Maria Von Weber|Cristoph Gedschold|Euryanthe|Roland Aeschlimann
CHRISTINE LIBOR|"Euryanthe"|Badisches Staatstheater di Karlsruhe|Carl Maria Von Weber|Cristoph Gedschold|Eglantine|Roland Aeschlimann
ALEX MARTINI|"Il Barbiere di Siviglia" al Comunale di Ferrara|"La vedova allegra"|Antonio Pirolli|Fiorello|Franz Lehár|Gioachino Rossini|Italo Nunziata|Jesi, Teatro Pergolesi|La bottega e i clienti vanitosi|Sergio Alapont|Visconte Cascada|Vittorio Sgarbi
ARMIN KOLARCZYK|"Euryanthe"|Badisches Staatstheater di Karlsruhe|Carl Maria Von Weber|Cristoph Gedschold|Lysiart|Roland Aeschlimann
BRIAN-MICHAEL FISCHER|"Euryanthe"|Badisches Staatstheater di Karlsruhe|Carl Maria Von Weber|Cristoph Gedschold|Roland Aeschlimann|Rudolph
BERNHARD BERCHTOLD|"Die Zauberflöte" (Il Flauto Magico)|"Euryanthe"|"La Vedova allegra"|Adolar|Alfred Eschwé|Badisches Staatstheater di Karlsruhe|Cagliari|Camille de Rossillon|Carl Maria Von Weber|Christopher Franklin|Cristoph Gedschold|Federico Tiezzi|Franz Lehár|Roberto Andò|Roland Aeschlimann|San Carlo di Napoli|Tamino|Wolfgang Amadeus Mozart
VINCENT WOLFSTEINER|"Tristan und Isolde"|-|Marcus Bosch|Monique Wagemakers|Teatro Comunale "Pavarotti" di Modena|Tristan
CLAUDIA ITEN|"Tristan und Isolde"|-|Isolde|Marcus Bosch|Monique Wagemakers|Teatro Comunale "Pavarotti" di Modena
MARTIN PLATZ|"Tristan und Isolde"|-|Marcus Bosch|Monique Wagemakers|Teatro Comunale "Pavarotti" di Modena|Un pastore / voce di un giovane marinaio
FABIAN VELOZ|"Macbeth"|"Rigoletto"|Giampaolo Maria Bisanti|Giandomenico Vaccari|Giovanni Di Stefano|Giuseppe Verdi|Henning Brockhaus|Macbeth|Modena|Rigoletto|Trieste, Teatro Verdi
MARCELLO VANNUCCI|"La rondine"|Giacomo Puccini|Gino Zampieri|Massimiliano Stefanelli|Modena, Teatro Comunale|Ruggero
ANNALISA STROPPA|"Così fan tutte"|"Der Schauspieldirektor", "La Canterina"|"Hänsel und Gretel"|"I due Figaro"|"Il Barbiere di Siviglia"|"Le nozze di Figaro"|"Nabucco"|"Norma"|"Roméo et Juliette"|-|Adalgisa|Adalgisa, druidessa|Apollonia|Bilbao, Teatro Arriaga|Buenos Aires|Cagliari, Teatro Lirico|Calixto Bieito|Charles Gounod|Cherubino|Comunale di Sassari|Domenico Cimarosa|Dorabella|Dorina|Emilia|Emilio Sagi|Engelbert Humperdinck|Enrichetta di Francia|Evelino Pidò|Fabio Luisi|Fenena|Francesco Micheli|Gaetano D’espinosa|Genova, Teatro Carlo Felice|Georges Bizet|Gioachino Rossini|Hubert Soudant|Hänsel|Jacopo Spirei|Jean-louis Grinda|Jean-luc Tingaud|Jossi Wieler|Jürgen Flimm|La liberté!» Carmen al Regio di Torino|Lola|Lorenzo Mariani|Madrid, Teatro Real|Manfred Schweigkofler|Marco Carniti|Marina Bianchi|Mercédès|Mme. Pfeil|Modena, Teatro Comunale|Muhai Tang|Pablo Mielgo|Padova, Teatro Verdi|Paolo Miccichè|Paolo Rossi|Pier Luigi Pizzi|Pietro Mascagni|Pinchas Steinberg|Renato Palumbo|Riccardo Muti|Riccardo Muti dirige "I due Figaro"|Roma, Terme di Caracalla|Rosina|Saverio Marconi|Saverio Mercadante|Saverio Santoliquido,Yutaka Sado|Stefano Montanari|Stéphano|Teatro Massimo di Palermo|Teatro Real di Madrid|Teatro Regio di Torino|Teatro alla Scala|Terme di Caracalla|Tiziano Severini|Verona, Arena Opera Festival|Vincenzo Bellini|Vittorio Borrelli|Will Humburg|Wolfgang Amadeus Mozart|Wolfgang Amadeus Mozart,Franz Joseph Haydn|Yves Abel|«Et surtout la chose enivrante|“Cavalleria Rusticana”|“I Puritani”|“Otello” di Rossini
PIETRO DI BIANCO|"Il cappello di paglia di Firenze"|"Il viaggio a Reims"|-|Beaupertuis|Don Profondo|Elena Barbalich|Giampiero Solari|Gioacchino Rossini|Giuseppe La Malfa|Matteo Beltrami|Novara, Teatro Coccia|Petruzzelli di Bari
MARIA PIA PISCITELLI|"Don Giovanni"|"La Vedova allegra"|"Norma"|-|Alessandro Talevi|Alfred Eschwé|Andrea De Rosa|Andriy Yurkevych|Caracalla Festival|Damiano Michieletto|Donna Elvira|Elisabetta|Federico Tiezzi|Franz Lehár|Gabriele Ferro|Gaetano Donizetti|Gioachino Rossini|Hanna Glawari|Luca Ronconi|Norma|San Carlo di Napoli|Semiramide|Stefano Montanari|Teatro Real di Madrid|Venezia, Teatro La Fenice|Vincenzo Bellini|Wolfgang Amadeus Mozart|“Roberto Devereux”
MARIA ALEIDA|"I puritani"|"Il signor Bruschino"|"Il viaggio a Reims"|-|Carmelo Rifici|Daniele Rustioni|Elvira|Elvira Valton, figlia di Gualtiero|Fabio Ceresa|Giacomo Sagripanti|Giampiero Solari|Gioacchino Rossini|Gioachino Rossini|La contessa di Folleville|Matteo Beltrami|Novara, Teatro Coccia|Opera di Firenze|Rossini Opera Festival|Sofia|Splendida lettura registica e vocale di "Puritani"|Teatro Pergolesi di Jesi|Teatro Sotterraneo|Vincenzo Bellini
MARCO BUSSI|"Così fan tutte"|"L'elisir d'amore"|"Madama Butterfly"|Alvise Casellati|Belcore|Carlo Felice di Genova|Fabio Ceresa|Filippo Crivelli|Gaetano Donizetti|Giacomo Puccini|Giovanni Battista Rigon|Giuseppe Finzi|Guglielmo, ufficiale, amante di Fiordiligi|Il principe Yamadori|Lorenzo Regazzo|Teatro Olimpico di Vicenza|Teatro Petruzzelli di Bari|Wolfang Amadeus Mozart
ANDREA ZAUPA|"La rondine"|"La vedova allegra"|"Lucrezia Borgia"|-|Andrea Sanguineti|Gaetano Donizetti|Giacomo Puccini|Gino Zampieri|Giulio Ciabatti|Gubetta|Lucca, Teatro del Giglio|Massimiliano Stefanelli|Modena, Teatro Comunale|Nicola Berloffa|Piacenza, Teatro Municipale|Pritschitch|Périchaud|Tiziano Severini|Verdi di Padova
TERESA IERVOLINO|"Il barbiere di Siviglia"|"Il viaggio a Reims"|"Juditha Triumphans"|"L'Amico Fritz"|"La Cenerentola"|"Lucrezia Borgia"|"Tancredi"|Alessandro De Marchi|Alessandro Talevi|Angelina|Antonio Vivaldi|Beppe|Davide Livermore|Donato Renzetti|Elena Barbalich|Fabrizio Maria Carminati|Francesco Cilluffo|Francesco Frongia|Gaetano Donizetti|Giampiero Solari|Gioacchino Rossini|Gioachino Rossini|Giulio Ciabatti|Holofernes|La marchesa Melibea|Maffio Orsini|Matteo Beltrami|Novara, Teatro Coccia|Pavia, Teatro Fraschini|Pietro Mascagni|Rosina|Simona Marchini|Speranza Scappucci|Tancredi|Teatro La Fenice di Venezia|Teatro dell'Opera di Roma|Tiziano Severini|Torino, Teatro Regio|Venezia, Teatro La Fenice|Verdi di Padova
ANICIO ZORZI GIUSTIANINI|"I due Figaro"|Buenos Aires|Emilio Sagi|Madrid, Teatro Real|Riccardo Muti|Riccardo Muti dirige "I due Figaro"|Saverio Mercadante|Torribio (Don Álvaro)
BORIS LICHTENBERGER|"I due Figaro"|Buenos Aires|Emilio Sagi|Madrid, Teatro Real|Riccardo Muti|Riccardo Muti dirige "I due Figaro"|Saverio Mercadante|Un servo
TERESA GARGANO|"La vedova allegra"|-|Donna Vincenza|Fabio Sparvoli|Lucca, Teatro del Giglio|Nicola Paszkowski|Nino Rota|Olga|“Napoli milionaria”
BJARNI THOR KRISTINSSON|"Die Zauberflöte" (Il Flauto Magico)|Cagliari|Christopher Franklin|Roberto Andò|Sarastro|Wolfgang Amadeus Mozart
CORNELIA GOETZ|"Die Zauberflöte"|"Die Zauberflöte" (Il Flauto Magico)|Cagliari|Christopher Franklin|Gabriele Ferro|La Regina della Notte|Regina della notte|Roberto Andò|Teatro Massimo di Palermo|Wolfgang Amadeus Mozart
ELIAS MADLER|"Die Zauberflöte" (Il Flauto Magico)|Cagliari|Christopher Franklin|Roberto Andò|Tölzer Knaben Chor (JACOB GOPFERT|Wolfgang Amadeus Mozart
JINKUNG PARK|"Die Zauberflöte" (Il Flauto Magico)|Cagliari|Christopher Franklin|Prima Dama|Roberto Andò|Wolfgang Amadeus Mozart
VENERA GIMADIEVA|-|Emilio Sagi|Evelino Pidò|Lady Elvira Valton|Teatro Real di Madrid|“I Puritani”
NICOLAS TESTÉ|-|Emilio Sagi|Evelino Pidò|Sir Giorgio|Teatro Real di Madrid|“I Puritani”
PEPPE BARRA|"La Vedova allegra"|Alfred Eschwé|Federico Tiezzi|Franz Lehár|Njegus|San Carlo di Napoli
VALENTINA FARCAS|"La Vedova allegra"|Alfred Eschwé|Federico Tiezzi|Franz Lehár|San Carlo di Napoli|Valencienne
VALERIO NAPOLI|"Il Barbiere di Siviglia"|"Il barbiere di Siviglia"|-|Ambrogio|Brescia, Teatro Grande|Como, Teatro Sociale|Federico Grazzini|Matteo Beltrami
BRUNO PRATICÒ|"Il Barbiere di Siviglia"|"Il matrimonio segreto" a Novara|"Il viaggio a Reims"|"La Vedova allegra"|"Turandot"|-|Alfred Eschwé|Andrea Battistoni|Bartolo|Carlo Goldstein|Daniele Rustioni|Domenico Cimarosa|Federico Tiezzi|Firenze, Teatro Comunale|Franz Lehár|Geronimo|Giacomo Puccini|Giampiero Solari|Gioacchino Rossini|Gioachino Rossini|Il Barone Mirko Zeta|Il Barone di Trombonok|Il barone di Trombonok|Marco Castoldi|Marco Gandini|Matteo Beltrami|Mercedes Martini|Novara, Teatro Coccia|Parma, Teatro Regio|Ping|San Carlo di Napoli|Stefano Vizioli|«Tutti quanti han da brillar» per Cimarosa al Coccia
VALENTIN KUCHLER)|"Die Zauberflöte" (Il Flauto Magico)|Cagliari|Christopher Franklin|Roberto Andò|Tölzer Knaben Chor (JACOB GOPFERT|Wolfgang Amadeus Mozart
BRUNO NOGARA|"Luisa Miller"|-|Donato Renzetti|Giuseppe Verdi|Teatro Comunale di Ferrara|Un contadino
JUNHUA HAO|"Luisa Miller"|-|Donato Renzetti|Federica|Giuseppe Verdi|Teatro Comunale di Ferrara
MEDET CHOTABAYEV|"Luisa Miller"|-|Donato Renzetti|Giuseppe Verdi|Rodolfo|Teatro Comunale di Ferrara
SILVIA PANTANI|"La traviata"|"Luisa Miller"|-|Carlomoreno Volpini|Donato Renzetti|Giuseppe Verdi|Luisa|Renato Bonajuto|Teatro Comunale di Ferrara|Teatro Goldoni di Livorno|Violetta Valéry
MATTEO MAZZOLI|"Madama Butterfly"|"Otello"|"Pagliacci", "Gianni Schicchi"|Daniele Callegari|Federico Grazzini|Francesco Ivan Ciampa|Francesco Lanzillotta|Giacomo Puccini|Giulio Ciabatti|Giuseppe Verdi|Il principe Yamadori|Parma, Teatro Regio|Pier Luigi Pizzi|Pinellino, calzolaio|Teatro Regio di Parma|Un araldo
NATASHA PETRINSKY|"Hänsel und Gretel"|"The rake's progress"|Baba la Turca|Damiano Michieletto|Diego Matheuz|Engelbert Humperdinck|Igor Stravinskij|Knusperhexe|Pinchas Steinberg|Teatro La Fenice di Venezia|Teatro Regio di Torino|Vittorio Borrelli
ROBERTO GUENNO|"Aida"|"Příhody lišky Bystroušky" (La piccola volpe astuta)|-|Gianandrea Noseda|Giuseppe Verdi|Jan Latham-koening|Pάsek|Robert Carsen|Torino, Teatro Regio|Un messaggero|William Friedkin
JUAN ANTONIO SANABRIA|Alessandro Talevi|Andriy Yurkevych|Gaetano Donizetti|Lord Guglielmo Cecil|Teatro Real di Madrid|“Roberto Devereux”
KOBA SARDALASHVILI|Alessandro Talevi|Andriy Yurkevych|Gaetano Donizetti|Teatro Real di Madrid|Un domestico del Duca|“Roberto Devereux”
NOVELLA BASSANO|"Il Barbiere di Siviglia" al Comunale di Ferrara|-|Berta|Cesare Scarton|Elvira|Gioachino Rossini|Italo Nunziata|La bottega e i clienti vanitosi|Marco Moresco|Sergio Alapont
ANDREI BOGATS|-|Lucca, Teatro del Giglio|Nino Rota|Pascalino ’o pittore|“Napoli milionaria”
ANTONIO SAPIO|-|Federico|Lucca, Teatro del Giglio|Nino Rota|“Napoli milionaria”
RALUCA PESCARU|-|Donna Peppenella|Lucca, Teatro del Giglio|Nino Rota|“Napoli milionaria”
GIANLUCA TUMINO|-|Lucca, Teatro del Giglio|Nino Rota|O miezo prevete|“Napoli milionaria”
VALERIA ESPOSITO|"La vedova allegra"|-|Antonio Pirolli|Francesco Esposito|Franz Lehár|Hanna Glawari|Jesi, Teatro Pergolesi|Marco Boemi|Micaela|Vittorio Sgarbi
LEO AN|"Attila"|"Cavalleria rusticana" e "Pagliacci"|"Rigoletto"|Alessio Pizzech|Alfio|Andrea Battistoni|Arnaud Bernard|Ezio, generale romano|Fabrizio Maria Carminati|Georges Lavaudant|Giuseppe Verdi|Jonathan Webb|Pietro Mascagni|Pisa, Teatro Verdi|Rigoletto|Tonio|Verona, Teatro Filarmonico
MARCELLO ROSIELLO|"Cavalleria rusticana" e "Pagliacci"|"Il Barbiere di Siviglia"|"Il barbiere di Siviglia"|"Madama Butterfly"|"Pagliacci", "Gianni Schicchi"|"Turandot"|-|Alberto Veronesi|Alessio Pizzech|Bologna, Teatro Comunale|Brescia, Teatro Grande|Como, Teatro Sociale|Fabio Mastrangelo|Federico Grazzini|Figaro|Francesco Ivan Ciampa|Giacomo Puccini|Jonathan Webb|Liliana Cavani|Lucca, Teatro del Giglio|Marco|Matteo Beltrami|Parma, Teatro Regio|Pietro Mascagni|Ping|Pisa, Teatro Verdi|Roberto De Simone|Sandro Pasqualetto|Sharpless|Silvio|Valerio Galli
ANDREA VINCENZO BONSIGNORE|"Il Barbiere di Siviglia"|"Il barbiere di Siviglia"|"Il signor Bruschino"|"La vedova allegra"|-|Bogdanowitch|Brescia, Teatro Grande|Como, Teatro Sociale|Daniele Rustioni|Federico Grazzini|Filiberto|Fiorello|Francesco Esposito|Gino Landi|Gioachino Rossini|Marco Boemi|Matteo Beltrami|Morales|Roberto Gianola|Rossini Opera Festival|Teatro Sotterraneo|Verona, Teatro Filarmonico
ADRIEN CHARLES PAGE|"Il Barbiere di Siviglia"|"Il barbiere di Siviglia"|-|Brescia, Teatro Grande|Como, Teatro Sociale|Federico Grazzini|Matteo Beltrami|Un ufficiale
MIKHAIL KOROBEINIKOV|"Il Barbiere di Siviglia"|"Il barbiere di Siviglia"|"La muette de Portici"|"Madama Butterfly"|"Samson et Dalila"|Abimelech|Alain Guingal|Bari, Teatro Petruzzelli|Camille Saint-saëns|Carlus Padrissa/la Fura Dels Baus|Charles Dutoit|Daniel-francois-esprit Auber|Davide Livermore|Don Basilio|Donato Renzetti|Emma Dante|Fabio Ceresa|Giacomo Puccini|Gioachino Rossini|Giuseppe Finzi|Lo zio bonzo|Lorenzo Mariani|Opera di Roma|Roma, Terme di Caracalla|Selva|Stefano Montanari|Teatro Petruzzelli di Bari|Teatro dell'Opera di Roma
ANTONIO MUSERRA|"La Traviata"|"Madama Butterfly"|"Rigoletto"|"Tosca"|Alberto Veronesi|Bari, Teatro Petruzzelli|Carlo Rizzari|Daniele Rustioni|Denis Krief|Fabio Ceresa|Ferzan Özpetek|Giacomo Puccini|Giuseppe Finzi|Giuseppe Verdi|L’ufficiale del registro|Marullo|Michele Mirabella|Petruzzelli di Bari|Sciarrone|Teatro Petruzzelli di Bari|Un commissionario|Un domestico di Flora
SOFIO JANELIDZE|"Il viaggio a Reims"|"Rigoletto"|-|Adelaide Schiano|Giampiero Solari|Gilbert Deflò|Gioacchino Rossini|Giovanna|Giuseppe Verdi|James Conlon|Lucca, Teatro del Giglio|Matteo Beltrami|Modestina|Nino Rota|Novara, Teatro Coccia|Scala|“Napoli milionaria”
EMANUELA GRASSI|"La traviata"|-|Annina|Carlomoreno Volpini|Flora Bervoix|Francesco Lanzillotta|Giuseppe Verdi|Henning Brockhaus|Renato Bonajuto|Teatro Goldoni di Livorno
ALESSANDRA MASINI|"La vedova allegra"|"Norma"|-|Alberto Fassini|Alessio Pizzech|Clotilde|Coccia di Novara|Fabio Sparvoli|Il dittico "Zanetto/Cavalleria Rusticana"|Livorno|Lucca, Teatro del Giglio|Matteo Beltrami|Nicola Paszkowski|Pietro Mascagni|Prakowia|Valerio Galli|Zanetto
LOREDANA ARCURI|"Die Zauberflöte" (Il flauto magico)|"Il Barbiere di Siviglia"|"Il barbiere di Siviglia"|-|Berta|Brescia, Teatro Grande|Como, Teatro Sociale|Eugenio Monti Colla|Federico Grazzini|Matteo Beltrami|Oliver Gooch|Prima Dama|Wolfgang Amadeus Mozart
STEFANO LA COLLA|"Aida"|"Nabucco"|-|Antoine Selva|Giacomo Puccini|Gianluca Martinenghi|Giuseppe Verdi|Il cavaliere Renato Des Grieux|Ismaele|Palermo|Pisa, Teatro Verdi|Radamès|Roberto Gianola|Teatro Verdi di Pisa|Tulio Gagliardo|“Manon Lescaut” per l’Orchestra Sinfonica Siciliana
MICHAIL RYSSOV|"Don Giovanni"|"Il Corsaro"|"Rigoletto"|-|Corrado Rovaris|Giandomenico Vaccari|Gianluigi Gelmetti|Giovanni Di Stefano|Giovanni, Corsaro|Giuseppe Verdi|Il Commendatore|Lorenzo Amato|Michele Mirabella|Modena|Palermo, Teatro Massimo|Sparafucile|Stefano Ranzani|Trieste, Teatro Verdi|Wolfgang Amadeus Mozart
MURAT CAN GÜVEN|"Il viaggio a Reims"|Don Luigino|Giampiero Solari|Gioacchino Rossini|Matteo Beltrami|Novara, Teatro Coccia
STEFANO MARCHISIO|"Il viaggio a Reims"|"La vedova allegra"|-|Antonio|Cascada|Fabio Sparvoli|Giampiero Solari|Gioacchino Rossini|Lucca, Teatro del Giglio|Matteo Beltrami|Nicola Paszkowski|Novara, Teatro Coccia
CARLOTTA VICHI|"Il viaggio a Reims"|"Příhody lišky Bystroušky" (La piccola volpe astuta)|"Rigoletto"|-|Alessio Pizzech|Busseto, Teatro Verdi|Fabrizio Cassi|Giampiero Solari|Gioacchino Rossini|Giovanna|Giuseppe Verdi|Il dittico "Zanetto/Cavalleria Rusticana"|Jan Latham-koening|Lapák|Livorno|Maddalena|Mamma Lucia|Matteo Beltrami|Novara, Teatro Coccia|Pietro Mascagni|Robert Carsen|Torino, Teatro Regio|Valerio Galli
MANUELA RANNO|"Il viaggio a Reims"|Delia|Giampiero Solari|Gioacchino Rossini|Matteo Beltrami|Novara, Teatro Coccia
IRENE BOTTARO|"Cavalleria rusticana" e "Pagliacci"|Alessio Pizzech|Jonathan Webb|Mamma Lucia|Pietro Mascagni|Pisa, Teatro Verdi
JAVIER PALACIOS|"Cavalleria rusticana" e "Pagliacci"|Alessio Pizzech|Jonathan Webb|Pietro Mascagni|Pisa, Teatro Verdi|Turiddu
NICOLÒ DONINI|"L'occasione fa ladro"|"La Bohème"|"Rigoletto"|Alessandro D’agostini|Alessio Pizzech|Andrea Cigni|Bergamo, Teatro Donizetti|Busseto, Teatro Verdi|Fabrizio Cassi|Giacomo Puccini|Gioachino Rossini|Giuseppe Verdi|Il Conte di Ceprano|Ivan Stefanutti|Martino|Parma, Teatro Regio|Stefano Romani|Un doganiere
ÀNGEL ÒDENA|"L'elisir d'amore"|Barcellona, Gran Teatre del Liceu|Belcore|Daniele Callegari|Gaetano Donizetti|Mario Gas Cabré
JAVIER CAMARENA|"L'elisir d'amore"|-|Barcellona, Gran Teatre del Liceu|Daniele Callegari|Emilio Sagi|Evelino Pidò|Gaetano Donizetti|Lord Arturo Talbo|Mario Gas Cabré|Nemorino|Teatro Real di Madrid|“I Puritani”
ELIANA BAYÓN|"L'elisir d'amore"|Barcellona, Gran Teatre del Liceu|Daniele Callegari|Gaetano Donizetti|Giannetta|Mario Gas Cabré
DANIELE CUSARI|"Don Giovanni Tenorio o sia Il convitato di pietra"|"La Traviata"|"La forza del destino"|"La vedova allegra"|"Macbeth"|"Madama Butterfly"|"Rigoletto"|"Tosca"|"Turandot"|-|Alessio Pizzech|Andrea Sanguineti|Brescia, Teatro Grande|Elena Barbalich|Federico Bardazzi|Francesco Lanzillotta|Giacomo Puccini|Giampaolo Bisanti|Giancarlo Cobelli|Giandomenico Vaccari|Giovanni Di Stefano|Giulio Ciabatti|Giuseppe Verdi|Il Barone Mirko Zeta|Il Commendatore|Il Conte di Monterone|Il dottor Grenvil|Jader Bignamini|Lo zio Bonzo|Matteo Beltrami|Mercedes Martini|Modena|Modena, Teatro Comunale|Nicola Berloffa|Novara, Teatro Coccia|Parma, Teatro Regio|Piacenza, Teatro Municipale|Pietro Rizzo|Pisa, Teatro Verdi|Rosetta Cucchi|Sciarrone/un carceriere|Sicario/Araldo|Stefano Poda|Teatro Regio di Parma|Un alcade|Un mandarino
TOMMASO QUANILLI|"La vedova allegra"|-|Fabio Sparvoli|Kromow|Lucca, Teatro del Giglio|Nicola Paszkowski
MARIO BRANCACCIO|"La vedova allegra"|-|Fabio Sparvoli|Lucca, Teatro del Giglio|Nicola Paszkowski|Njegus
ROMANO FRANCI|"La traviata"|"Rigoletto"|"Tristan und Isolde"|-|Casciana Terme|Giandomenico Vaccari|Giovanni Di Stefano|Giuseppe Verdi|Il Marchese d’Obigny|Marcus Bosch|Matteo Beltrami|Modena|Monique Wagemakers|Renato Bonajuto|Teatro Comunale "Pavarotti" di Modena|Un timoniere|Usciere di corte
STEFANO SORRENTINO|-|Cesare Scarton|Gioachino Rossini|Lindoro|Marco Moresco
MARIANNA PETRECCA|-|Cesare Scarton|Gioachino Rossini|Marco Moresco|Zulma
LUCIANO DI PASQUALE|"La cena delle beffe"|-|Carlo Rizzi|Cesare Scarton|Gioachino Rossini|Il Tornaquinci|Marco Moresco|Mario Martone|Milano, Teatro alla Scala|Mustafà|Umberto Giordano
MIYAMOTO FUMITOSHI|-|Cesare Scarton|Gioachino Rossini|Marco Moresco|Taddeo
CORRADO CALDA|"La vedova allegra"|-|Andrea Sanguineti|Nicola Berloffa|Njegus|Piacenza, Teatro Municipale
ANDREA PELLEGRINI|"La cambiale di matrimonio"|Andrea Cigni|Francesco Cilluffo|Gioachino Rossini|Norton|Parma, Teatro Regio|Valli di Reggio Emilia
FEDERICA CACCIATORE|"L'occasione fa ladro"|"La cambiale di matrimonio"|Alessandro D’agostini|Andrea Cigni|Clarina|Ernestina|Francesco Cilluffo|Gioachino Rossini|Parma, Teatro Regio|Valli di Reggio Emilia
FUMITOSHI MIYAMOTO|"La cambiale di matrimonio"|Andrea Cigni|Francesco Cilluffo|Gioachino Rossini|Parma, Teatro Regio|Slook|Valli di Reggio Emilia
LORENZO CALTAGIRONE|"La cambiale di matrimonio"|Andrea Cigni|Edoardo Milfort|Francesco Cilluffo|Gioachino Rossini|Parma, Teatro Regio|Valli di Reggio Emilia
MARCO GRANATA|"La cambiale di matrimonio"|Andrea Cigni|Francesco Cilluffo|Gioachino Rossini|Parma, Teatro Regio|Tobia Mill|Valli di Reggio Emilia
NAO YOKOMAE|"L'occasione fa ladro"|"La cambiale di matrimonio"|Alessandro D’agostini|Andrea Cigni|Berenice|Fanny|Francesco Cilluffo|Gioachino Rossini|Parma, Teatro Regio|Valli di Reggio Emilia
ALESSANDRO SAFINA|"La vedova allegra"|-|Andrea Sanguineti|Antonio Pirolli|Conte Danilo Danilowitsh|Franz Lehár|Il Conte Danilo Danilowitch|Jesi, Teatro Pergolesi|Nicola Berloffa|Piacenza, Teatro Municipale|Vittorio Sgarbi
CHIARA MANESE|"La vedova allegra"|-|Andrea Sanguineti|Nicola Berloffa|Olga|Piacenza, Teatro Municipale
MICHELA NARDELLA|"Rigoletto"|Giandomenico Vaccari|Giovanni Di Stefano|Giuseppe Verdi|Maddalena|Modena
ILINA MIHAYLOVA|"Rigoletto"|Giandomenico Vaccari|Gilda|Giovanni Di Stefano|Giuseppe Verdi|Modena
HO-YOON CHUNG|"Rigoletto"|Giandomenico Vaccari|Giovanni Di Stefano|Giuseppe Verdi|Il Duca di Mantova|Modena
ANNALISA FERRARINI|"Rigoletto"|Giandomenico Vaccari|Giovanni Di Stefano|Giuseppe Verdi|La Contessa|Modena
ALESSANDRA CANTIN|"Rigoletto"|Giandomenico Vaccari|Giovanni Di Stefano|Giuseppe Verdi|Modena|Paggio della Duchessa
ROBERTO CARLI|"Lucia di Lammermoor"|"Nabucco"|"Rigoletto"|Abdallo|Aldo Sisillo|Gaetano Donizetti|Giandomenico Vaccari|Giovanni Di Stefano|Giuseppe Verdi|Henning Borckhaus|Henning Brockhaus,Valentina Escobar|Jesi, Teatro Pergolesi|Matteo Borsa|Modena|Normanno|Normanno, capo degli armigeri di Ravenswood|Parma, Teatro Regio|Piacenza, Teatro Municipale|Stefano Monti|Stefano Ranzani
PAOLOA LEVERONI|"Rigoletto"|Giandomenico Vaccari|Giovanna|Giovanni Di Stefano|Giuseppe Verdi|Modena
MAMUKA LOMIDZE|Alessio Pizzech|Compare Alfio|Il dittico "Zanetto/Cavalleria Rusticana"|Livorno|Pietro Mascagni|Valerio Galli
MARKUS WERBA|"Die Zauberflöte"|"Die Zauberflöte" (Il Flauto Magico)|"Don Giovanni"|"Il flauto magico"|"La Bohème"|"La Vedova allegra"|"La vedova allegra"|"Pelléas et Mélisande"|-|Alfred Eschwé|Andrea Battistoni|Antonello Manacorda|Buenos Aires, Teatro Colón|Cagliari|Christian Arming|Christopher Franklin|Claude Debussy|Damiano Michieletto|Damiano Michieletto,Luca Scarzella|Don Giovanni|Emmanuel Villaume|Federico Tiezzi|Franz Lehár|Gabriele Ferro|Giacomo Puccini|Gino Landi|Il Conte Danilo Danilowitch|Il ritorno di "Don Giovanni"|Marcello|Olivia Fuchs|Papageno|Pelléas|Roberto Andò|Roberto Gianola|San Carlo di Napoli|Teatro La Fenice|Teatro Massimo di Palermo|Teatro Regio|Torino, Teatro Regio|Venezia, Teatro La Fenice|Verona, Teatro Filarmonico|Vittorio Borrelli|Wolfgang Amadeus Mozart
FRANCESCA BICHIERRI|"Madama Butterfly"|Fabio Ceresa|Giacomo Puccini|Giuseppe Finzi|La zia|Teatro Petruzzelli di Bari
GRAZIANO DE PACE|"Madama Butterfly"|Fabio Ceresa|Giacomo Puccini|Giuseppe Finzi|Teatro Petruzzelli di Bari|Yakusidè
SUSANNA CAVALLO|"Madama Butterfly"|Dolore|Fabio Ceresa|Giacomo Puccini|Giuseppe Finzi|Teatro Petruzzelli di Bari
IVANA PADOVANO|"Madama Butterfly"|Fabio Ceresa|Giacomo Puccini|Giuseppe Finzi|La madre|Teatro Petruzzelli di Bari
ROBERTA SCALAVINO|"Madama Butterfly"|Fabio Ceresa|Giacomo Puccini|Giuseppe Finzi|La cugina|Teatro Petruzzelli di Bari
CONCETTA D'ALESSANDRO|"Il Barbiere di Siviglia"|"Il barbiere di Siviglia"|-|Brescia, Teatro Grande|Como, Teatro Sociale|Federico Grazzini|Matteo Beltrami|Rosina
FABIO PERILLO|" Semiramide in Villa"|-|Garofalo|Giovanni Di Stefano|Stefania Panighini|Taranto, "Giovanni Paisiello Festival"
PASQUALE ARCAMONE|" Semiramide in Villa"|-|Giovanni Di Stefano|Monsieur Panbianco|Stefania Panighini|Taranto, "Giovanni Paisiello Festival"
ROBERTO LORENZI|"Il Barbiere di Siviglia"|"Il barbiere di Siviglia"|"La Bohème"|-|Brescia, Teatro Grande|Como, Teatro Sociale|Daniele Rustioni|Don Basilio|Federico Grazzini|Franco Zeffirelli|Giacomo Puccini|Matteo Beltrami|Milano, Teatro alla Scala|Un doganiere
FRANCESCO FACINI|"La rondine"|Giacomo Puccini|Gino Zampieri|Lucca, Teatro del Giglio|Massimiliano Stefanelli|Rambaldo Fernandez
MIRELLA DI VITA|"Il barbiere di Siviglia"|"La rondine"|"La traviata"|Aldo Tarabella|Berta|Casciana Terme|Daniele Agiman|Flora Bervoix|Giacomo Puccini|Gino Zampieri|Gioachino Rossini|Giuseppe Verdi|Lucca, Teatro del Giglio|Massimiliano Stefanelli|Matteo Beltrami|Modena, Cortile di Palazzo Ducale|Modena, Teatro Comunale|Renato Bonajuto|Yvette
CATERINA DANIELE|"Rigoletto"|Bari, Teatro Petruzzelli|Carlo Rizzari|Denis Krief|Giuseppe Verdi|Paggio
ROCCO CAVALLUZZI|"La Traviata"|"Rigoletto"|Alessio Pizzech|Bari, Teatro Petruzzelli|Busseto, Teatro Verdi|Carlo Rizzari|Conte di Ceprano|Daniele Rustioni|Denis Krief|Fabrizio Cassi|Ferzan Özpetek|Giuseppe Verdi|Il Conte di Monterone|Il dottor Grenvil|Petruzzelli di Bari
GIANFRANCO CAPPELLUTI|"La Traviata"|"Madama Butterfly"|"Rigoletto"|Bari, Teatro Petruzzelli|Carlo Rizzari|Conte di Monterone|Daniele Rustioni|Denis Krief|Fabio Ceresa|Ferzan Özpetek|Giacomo Puccini|Giuseppe Finzi|Giuseppe Verdi|Il barone Duphol|Il commissario imperiale|Petruzzelli di Bari|Teatro Petruzzelli di Bari
TERESA CARICOLA|"Rigoletto"|Bari, Teatro Petruzzelli|Carlo Rizzari|Contessa di Ceprano|Denis Krief|Giuseppe Verdi
ROSA FEOLA|"Don Pasquale"|"Falstaff"|"I due Figaro"|"La Bohème"|"La clemenza di Tito"|"Rigoletto"|-|Andrea Battistoni|Bruno Campanella|Buenos Aires|Carlo Rizzari|Daniele Rustioni|Davide Livermore|Emilio Sagi|Gaetano Donizetti|Giacomo Puccini|Gilda|Giuseppe Verdi|Inez|Leïla, sacerdotessa di Brahma|Lorenzo Amato|Louis Langrée|Luca Ronconi|Madrid, Teatro Real|Musetta|Nannetta|Norina|Parigi,Théâtre des Champs Elysées|Petruzzelli di Bari|Pinchas Steinberg|Riccardo Muti|Riccardo Muti dirige "I due Figaro"|Rolando Panerai|Roma, Teatro dell’Opera|Roma,Terme di Caracalla|Ruggero Cappuccio|Ryan Mcadams|Saverio Mercadante|Savona, Complesso Monumentale del Priamar|Servilia|Teatro San Carlo di Napoli|Wolfgang Amadeus Mozart|’Auditorium RAI di Torino|“Les pêcheurs de perles”
MALIN HARTELIUS|"La clemenza di Tito"|-|Louis Langrée|Parigi,Théâtre des Champs Elysées|Vitellia|Wolfgang Amadeus Mozart
MICHAEL SCHADE|"La clemenza di Tito"|-|Louis Langrée|Parigi,Théâtre des Champs Elysées|Tito|Wolfgang Amadeus Mozart
BRINDLEY SHERRAT|"La clemenza di Tito"|-|Louis Langrée|Parigi,Théâtre des Champs Elysées|Publio|Wolfgang Amadeus Mozart
CHRISTINA DALETSKA|"La clemenza di Tito"|-|Annio|Louis Langrée|Parigi,Théâtre des Champs Elysées|Wolfgang Amadeus Mozart
ELENA CROCE|"Cavalleria rusticana" e "Pagliacci"|Alessio Pizzech|Con la partecipazione dell’attrice|Jonathan Webb|Pietro Mascagni|Pisa, Teatro Verdi
CHIARA MATTIOLI|"Cavalleria rusticana" e "Pagliacci"|Alessio Pizzech|Jonathan Webb|Lola|Pietro Mascagni|Pisa, Teatro Verdi
LARA ROTILI|"Adriana Lecouvreur"|"Die Zauberflöte" (Il Flauto Magico)|"Falstaff"|"Nabucco"|"Rigoletto"|"Roméo et Juliette"|-|Alessio Pizzech|Andrea Battistoni|Andrea Cigni|Busseto, Teatro Verdi|Cagliari|Carlo Goldstein|Charles Gounod|Christopher Franklin|Comunale di Sassari|Fabrizio Cassi|Fenena|Francesco Cilea|Francesco Esposito|Gaetano D´espinosa|Gertrude|Giuseppe Verdi|Ivan Stefanutti|Leo Muscato|M.lle Dangeville|Mad.lla Dangeville|Maddalena|Marco Boemi|Marco Spada|Mercedes|Mrs. Meg Page|Roberto Andò|Sassari, Teatro Comunale|Seconda Dama|Sergio Alapont|Stagione lirica sassarese|Teatro Sociale di Como|Wolfgang Amadeus Mozart
PAOLO PECCHIOLI|"Aida"|"Il matrimonio segreto"|"Il viaggio a Reims"|"La Sonnambula"|"La forza del destino"|"Simon Boccanegra"|-|Arena Sferisterio di Macerata|Casciana Terme|Daniele Callegari|Domenico Cimarosa|Emiliana Paoli|Frà Melitone|Giampiero Solari|Gioacchino Rossini|Giorgio Barberio Corsetti|Giorgio Gallione|Giuseppe Verdi|Il Conte Rodolfo|Lord Sidney|Matteo Beltrami|Novara, Teatro Coccia|Petruzzelli di Bari|Pier Luigi Pizzi|Pietro|Ramfis|Regio di Parma|Roberto Zarpellon|San Galgano|Sig. Geronimo|Vincenzo Bellini
ASUDE KARAYAVUZ|"I Due Foscari"|"I due Figaro"|"I due Foscari"|"Rigoletto"|Andrea Battistoni|Arnaud Bernard|Buenos Aires|Emilio Sagi|Giudeppe Verdi|Giuseppe Verdi|Joseph Franconi Lee|La Contessa|Maddalena|Madrid, Teatro Real|Pisana|Renato Palumbo|Riccardo Muti|Riccardo Muti dirige "I due Figaro"|Roma, Teatro dell'Opera|Saverio Mercadante|Trieste|Verona, Teatro Filarmonico|Werner Herzog
RA HYUN KYU|"La traviata"|Carlomoreno Volpini|Giorgio Gérmont|Giuseppe Verdi|Renato Bonajuto|Teatro Goldoni di Livorno
SELENE FIASCHI|"La traviata"|Annina|Carlomoreno Volpini|Giuseppe Verdi|Renato Bonajuto|Teatro Goldoni di Livorno
FEDERICO BULLETTI|"La traviata"|Carlomoreno Volpini|Gastone|Giuseppe|Giuseppe Verdi|Renato Bonajuto|Teatro Goldoni di Livorno
IVAN CIGNETTI|"La traviata"|Carlomoreno Volpini|Danzatori|Giuseppe Verdi|Renato Bonajuto|Teatro Goldoni di Livorno
ALICE COOTE|"La clemenza di Tito"|-|Hänsel|Laurent Pelly|Louis Langrée|Parigi,Théâtre des Champs Elysées|Paul Daniel|Sesto|Teatro Real di Madrid|Wolfgang Amadeus Mozart|“Hänsel und Gretel”
SILVIA VÁZQUEZ|"Der Schauspieldirektor", "La Canterina"|"Un giorno di regno"|Alberto Zedda|Bilbao|Bilbao, Teatro Arriaga|Gasparina|Giulietta|Giuseppe Verdi|Marco Carniti|Mme. Hertz|Pablo Mielgo|Pier Luigi Pizzi|Wolfgang Amadeus Mozart,Franz Joseph Haydn
ARITZA RODRÍGUEZ|"Der Schauspieldirektor", "La Canterina"|Bilbao, Teatro Arriaga|Marco Carniti|Mr. Herz|Pablo Mielgo|Wolfgang Amadeus Mozart,Franz Joseph Haydn
ITZIAR DE UNDA|"Der Schauspieldirektor", "La Canterina"|Bilbao, Teatro Arriaga|Marco Carniti|Mlle. Silbrklang|Pablo Mielgo|Wolfgang Amadeus Mozart,Franz Joseph Haydn
FELIPE LOZA|"Der Schauspieldirektor", "La Canterina"|Bilbao, Teatro Arriaga|Frank|Marco Carniti|Pablo Mielgo|Wolfgang Amadeus Mozart,Franz Joseph Haydn
ELENA PANKRATOVA|"Cavalleria rusticana" e "Pagliacci"|"Die Walküre"|-|Alessio Pizzech|Firenze, Teatro Comunale|Jonathan Webb|La Fura Dels Baus (carlus Padrissa)|Pietro Mascagni|Pisa, Teatro Verdi|Santuzza|Sieglinde|Zubin Mehta
ALEXANDRE GUERRERO|"Der Schauspieldirektor", "La Canterina"|Bilbao, Teatro Arriaga|Don Pelagio|M. Vogelsang|Marco Carniti|Pablo Mielgo|Wolfgang Amadeus Mozart,Franz Joseph Haydn
ALBERTO NÚÑEZ|"Der Schauspieldirektor", "La Canterina"|Bilbao, Teatro Arriaga|Heiler|Marco Carniti|Pablo Mielgo|Wolfgang Amadeus Mozart,Franz Joseph Haydn
ESTHER ANDALORO|"Cavalleria rusticana" e "Pagliacci"|"Don Giovanni"|"Don Quichotte"|"Le nozze di Figaro"|Alessio Pizzech|Cagliari, Teatro Lirico|Daniel Cohen,Marco Faelli|Donna Anna|Elisabetta Courir|Federico Tiezzi|Garcias|Genova, Teatro Carlo Felice|Giovanni Di Stefano|Hubert Soudant|Jonathan Webb|Jules Massenet|La contessa|Marina Bianchi|Nedda|Pietro Mascagni|Pisa, Teatro Verdi|Teatro Lirico di Cagliari|Wolfgang Amadeus Mozart
NICOLA VOCATURA|"Cavalleria rusticana" e "Pagliacci"|Alessio Pizzech|Contadini|Jonathan Webb|Pietro Mascagni|Pisa, Teatro Verdi
ANGELO FIORE|"La traviata"|"Otello"|"Turandot"|-|Alfredo Gérmont|Carlomoreno Volpini|Casciana Terme|Enrico Stinchelli|Festival Pucciniano|Francesco Ivan Ciampa|Giacomo Puccini|Giuseppe Verdi|Il principe ignoto (Calaf)|Matteo Beltrami|Maurizio Scaparro|Pisa, Teatro Verdi|Renato Bonajuto|Roderigo|Teatro Goldoni di Livorno
MARIA GRAZIA NOBILI|"Turandot"|Giacomo Puccini|Matteo Beltrami|Mercedes Martini|Novara, Teatro Coccia|Seconda ancella
NICOLA PISANIELLO|"Il viaggio a Reims"|"Turandot"|Gelsomino/Zefirino|Giacomo Puccini|Giampiero Solari|Gioacchino Rossini|L’imperatore Altoum|Matteo Beltrami|Mercedes Martini|Novara, Teatro Coccia
GIANLUCA MONTI|"La forza del destino"|"Rigoletto"|Alessio Pizzech|Busseto, Teatro Verdi|Fabrizio Cassi|Giandomenico Vaccari|Giovanni Di Stefano|Giuseppe Verdi|Jader Bignamini|Marullo|Modena|Stefano Poda|Teatro Regio di Parma|Un chirurgo|Un usciere di corte
YASKO SATO|"Madama Butterfly"|Cio-Cio-San|Fabio Ceresa|Firenze|Francesco Lanzillotta|Giacomo Puccini|Giampaolo Bisanti|Giulio Ciabatti|Giuseppe Finzi|Juraj Valcuha|Madama Butterfly (Cio Cio San)|Madama Butterfly (Cio-Cio San)|Opera di Firenze|Parma, Teatro Regio|Teatro Petruzzelli di Bari
DILETTA CENTONZE|"La traviata"|Carlomoreno Volpini|Danzatori|Giuseppe Verdi|Renato Bonajuto|Teatro Goldoni di Livorno
ANTONIO CANDIA|"La traviata"|Carlomoreno Volpini|Giuseppe Verdi|Renato Bonajuto|Teatro Goldoni di Livorno|Un domestico
ANDREA MARMUGI|"La traviata"|Carlomoreno Volpini|Giuseppe Verdi|Renato Bonajuto|Teatro Goldoni di Livorno|Un domestico
ALESSANDRO MARTINELLO|"La traviata"|Carlomoreno Volpini|Giuseppe Verdi|Il Marchese d’Obigny|Il commissario|Renato Bonajuto|Teatro Goldoni di Livorno
STEFANO CESCATTI|"La Traviata"|"Rigoletto"|Domestico di Flora|Giandomenico Vaccari|Giovanni Di Stefano|Giuseppe Verdi|Il Conte di Ceprano|Modena|Modena, Teatro Comunale|Pietro Rizzo|Rosetta Cucchi
ELIA TODISCO|"Aida"|"Nabucco"|"Turandot"|-|Antoine Selva|Franco Zeffirelli|Giacomo Puccini|Gianluca Martinenghi|Giuseppe Verdi|Marcello Bufalini|Matteo Beltrami|Mercedes Martini|Nicola Zorzi|Novara, Teatro Coccia|Pisa, Teatro Verdi|Ramfis|Teatro Verdi di Pisa|Teramo, Teatro Comunale|Timur|Zaccaria
ALESSANDRA REZZA|"Nabucco"|"Norma"|-|Abigaille|Alberto Fassini|Carlo Antonio De Lucia|Coccia di Novara|Francesco Ledda|Giuseppe Verdi|Luglio Musicale Trapanese|Marcello Bufalini|Matteo Beltrami|Nicola Zorzi|Norma|Teramo, Teatro Comunale
ROUWEN HUTHER|"Die Zauberflöte" (Il Flauto Magico)|Cagliari|Christopher Franklin|Primo armigero|Roberto Andò|Wolfgang Amadeus Mozart
SELCUK CARA|"Die Zauberflöte" (Il Flauto Magico)|Cagliari|Christopher Franklin|Roberto Andò|Secondo armigero|Wolfgang Amadeus Mozart
BETTINA RANCH|"Die Zauberflöte"|"Die Zauberflöte" (Il Flauto Magico)|Bologna, Teatro Comunale|Cagliari|Christopher Franklin|Dritte Dame (Terza dama)|Luigi De Angelis|Michele Mariotti|Roberto Andò|Terza Dama|Wolfgang Amadeus Mozart
JESÚS LÉON|"I puritani"|-|Fabio Ceresa|Lord Arturo Talbo|Matteo Beltrami|Opera di Firenze
ENRICO GIOVAGNOLI|"La vedova allegra"|Antonio Pirolli|Franz Lehár|Jesi, Teatro Pergolesi|Raoul de St. Brioche|Vittorio Sgarbi
ENZO BOCCANERA|"La vedova allegra"|Antonio Pirolli|Bogdanowitsch|Franz Lehár|Jesi, Teatro Pergolesi|Vittorio Sgarbi
ALBERTO PIASTRELLINI|"La vedova allegra"|Antonio Pirolli|Franz Lehár|Jesi, Teatro Pergolesi|Pritschitsch|Vittorio Sgarbi
VITALIY KOVALCHUK|Alessio Pizzech|Il dittico "Zanetto/Cavalleria Rusticana"|Livorno|Pietro Mascagni|Turiddu|Valerio Galli
YVONNE MANFREDA|Alessio Pizzech|Il dittico "Zanetto/Cavalleria Rusticana"|Livorno|Pietro Mascagni|Santuzza|Valerio Galli
NILA MASALA|-|Giacomo Puccini|Manon Lescaut|Palermo|Roberto Gianola|“Manon Lescaut” per l’Orchestra Sinfonica Siciliana
JAEHONG JUNG|"L'occasione fa ladro"|Alessandro D’agostini|Andrea Cigni|Don Parmenione|Gioachino Rossini|Parma, Teatro Regio
MANUEL AMATI|"L'occasione fa ladro"|"Rigoletto"|Alessandro D’agostini|Alessio Pizzech|Andrea Cigni|Busseto, Teatro Verdi|Conte Alberto|Fabrizio Cassi|Gioachino Rossini|Giuseppe Verdi|Matteo Borsa|Parma, Teatro Regio
ALESSANDRO VANNUCCI|"L'occasione fa ladro"|Alessandro D’agostini|Andrea Cigni|Don Eusebio|Gioachino Rossini|Parma, Teatro Regio
ELIŠKA WEISSOVÁ|"Příhody lišky Bystroušky" (La piccola volpe astuta)|-|Jan Latham-koening|La moglie del guardiacaccia e il gufo|Robert Carsen|Torino, Teatro Regio
SARA PALANA|"Nabucco"|Carlo Antonio De Lucia|Fenena|Francesco Ledda|Giuseppe Verdi|Luglio Musicale Trapanese
ENRICO BINDOCCI|"Nabucco"|Abdallo|Antoine Selva|Gianluca Martinenghi|Giuseppe Verdi|Pisa, Teatro Verdi
SERENA PASQUINI|"Nabucco"|Anna|Antoine Selva|Gianluca Martinenghi|Giuseppe Verdi|Pisa, Teatro Verdi
GIUSEPPE RAIMONDO|"La vedova allegra"|-|Danilo Danilowitsch|Fabio Sparvoli|Lucca, Teatro del Giglio|Nicola Paszkowski
MARIKA COLASANTO|"La vedova allegra"|-|Fabio Sparvoli|Lucca, Teatro del Giglio|Nicola Paszkowski|Valencienne
ALFONSO FRANCO|"La vedova allegra"|-|Fabio Sparvoli|Lucca, Teatro del Giglio|Nicola Paszkowski|Pritschitsch
DOMITILLA LAI|"La vedova allegra"|-|Fabio Sparvoli|Lucca, Teatro del Giglio|Nicola Paszkowski|Sylviane
FRANCESCO NAPOLEONI|"La vedova allegra"|-|Bogdanowitsch|Fabio Sparvoli|Lucca, Teatro del Giglio|Nicola Paszkowski
DANIELA CAPPIELLO|"L'Italiana in Algeri"|"Rigoletto"|Alessio Pizzech|Busseto, Teatro Verdi|Elvira|Fabrizio Cassi|Ferrara, Teatro Comunale|Francesco Ommassini|Gilda|Gioachino Rossini|Giuseppe Emilian,Giuseppe Emiliani|Giuseppe Verdi
MICKAEL SPADACCINI|"Cavalleria rusticana" e "Pagliacci"|"Les contes d'Hoffmann"|"Nabucco"|-|Alessio Pizzech|Canio|Christian Capocaccia|Daniele Abbado|Festival Verdi 2008|Frédéric Roels|Giuseppe Verdi|Hoffmann|Ismaele|Jacques Offenbach|Jonathan Webb|Michele Mariotti|Modena, Teatro Comunale|Pietro Mascagni|Pisa, Teatro Verdi|Teatro Fraschini di Pavia|Turiddu
ALESSIA MARTINA|-|Antonio Greco|Caterina Panti Liberovici|Laurina|Leonardo Leo
CAROLINA LIPPO|" Semiramide in Villa"|"Il Campiello" un "hit"|"La scala di seta"|"La vedova allegra"|-|Antonio Greco|Antonio Pirolli|Bepi Morassi|Caterina Panti Liberovici|Cintia|Ermanno Wolf-ferrari|Francesco Pasqualetti|Franz Lehár|Gioachino Rossini|Giovanni Di Stefano|Giulia|Gnese|Jesi, Teatro Pergolesi|Leonardo Leo|Madama Tenerina|Olga|Paolo Trevisi|Sociale di Rovigo|Stefania Panighini|Stefano Romani|Taranto, "Giovanni Paisiello Festival"|Teatro Comunale di Sassari|Vittorio Sgarbi
GREGORY WARREN|"Così fan tutte"|"Les Troyens"|-|Comunale di Sassari|Ferrando|Iopas /Hylas|Jacopo Spirei|Lawrence Foster|Marsiglia, Opéra Municipal|Wolfgang Amadeus Mozart
FILOMENA DIODATI|-|Antonio Greco|Caterina Panti Liberovici|Delfina|Leonardo Leo
RICCARDO GAGLIARDI|-|Antonio Greco|Caterina Panti Liberovici|Leonardo Leo|Lupino
ALESSANDRO GIANGRANDE|-|Alessio Pizzech|Apollo|Teatro Litta di Milano|“Apollo et Hyacinthus” di Mozart
ELINA SHIMKUS|-|Alessio Pizzech|Melia|Teatro Litta di Milano|“Apollo et Hyacinthus” di Mozart
GRAZIANO SCHIAVONE|-|Alessio Pizzech|Oebalus|Teatro Litta di Milano|“Apollo et Hyacinthus” di Mozart
VALERIA GIRARDELLO|"L'Italiana in Algeri"|-|Alessio Pizzech|Ferrara, Teatro Comunale|Francesco Ommassini|Gioachino Rossini|Giuseppe Emilian,Giuseppe Emiliani|Teatro Litta di Milano|Zephyrus|Zulma|“Apollo et Hyacinthus” di Mozart
VILIJA MIKŠTAITĖ|-|Alessio Pizzech|Hyacinthus|Teatro Litta di Milano|“Apollo et Hyacinthus” di Mozart
ÖZGECAN GENCER|"Euryanthe"|Badisches Staatstheater di Karlsruhe|Bertha|Carl Maria Von Weber|Cristoph Gedschold|Roland Aeschlimann
LUKAS SCHMIDT|"Euryanthe"|Badisches Staatstheater di Karlsruhe|Carl Maria Von Weber|Cristoph Gedschold|König Ludwig VI|Roland Aeschlimann
STEFANIA MAJARDI|"La vedova allegra"|-|Andrea Sanguineti|Nicola Berloffa|Piacenza, Teatro Municipale|Praskowia
PAOLA SANGUINETTI|"La vedova allegra"|-|Andrea Sanguineti|Anna Glavari|Nicola Berloffa|Piacenza, Teatro Municipale
VALENTINO SALVINI|"La vedova allegra"|-|Andrea Sanguineti|Kromow|Nicola Berloffa|Piacenza, Teatro Municipale
DIANA MIAN|"Die Zauberflöte"|"Don Giovanni"|"Il Campiello"|"Maria Stuarda"|"Příhody lišky Bystroušky" (La piccola volpe astuta)|-|Anna|Anna Kennedy|Bergamo, Teatro Donizetti|Bologna, Teatro Comunale|Carlo Montanaro|Charles Gounod|Damiano Michieletto|Ermanno Wolf-ferrari|Federico Bertolani|Filarmonico di Verona|Francesco Cilluffo|Gaetano Donizetti|Giovanni Battista Rigon|Il gallo e la ghiandaia|Jan Latham-koening|Juliette|Leo Muscato|Lucieta|Luigi De Angelis|Luçieta|Michele Mariotti|Paolo Trevisi|Robert Carsen|Sebastiano Rolli|Stefano Romani|Teatro dell'Opera di Firenze|Torino, Teatro Regio|Verona, Teatro Filarmonico|Vicenza, Teatro Olimpico|Wolfgang Amadeus Mozart|Zerlina|Zweite Dame (Seconda dama)
JEKUB KETTNER|"Příhody lišky Bystroušky" (La piccola volpe astuta)|-|Harašta|Jan Latham-koening|Robert Carsen|Torino, Teatro Regio
LADISLAV MLEJNEK|"Příhody lišky Bystroušky" (La piccola volpe astuta)|-|Il parroco e il tasso|Jan Latham-koening|Robert Carsen|Torino, Teatro Regio
JAROSLAV BŘEZINA|"Příhody lišky Bystroušky" (La piccola volpe astuta)|-|Il maestro di scuola|Jan Latham-koening|Robert Carsen|Torino, Teatro Regio
PAMELA CHIRIACO|"Così fan tutte"|-|Comunale di Sassari|Despina|Jacopo Spirei|Wolfgang Amadeus Mozart
tag|Giuseppe Verdi|74
tag|Giacomo Puccini|47
tag|Gioachino Rossini|42
tag|Matteo Beltrami|41
tag|Alessio Pizzech|39
tag|"Rigoletto"|32
tag|"La vedova allegra"|32
tag|Wolfgang Amadeus Mozart|29
tag|Pietro Mascagni|26
tag|Parma, Teatro Regio|24
tag|Lucca, Teatro del Giglio|23
tag|"Madama Butterfly"|21
tag|Renato Bonajuto|21
tag|"La traviata"|21
tag|Franz Lehár|19
tag|Novara, Teatro Coccia|19
tag|Pisa, Teatro Verdi|18
tag|Giovanni Di Stefano|17
tag|Gaetano Donizetti|17
tag|"Cavalleria rusticana" e "Pagliacci"|16
tag|Torino, Teatro Regio|16
tag|Modena, Teatro Comunale|16
tag|Giampiero Solari|15
tag|"Il viaggio a Reims"|15
tag|Fabio Ceresa|15
tag|Gioacchino Rossini|15
tag|"Il Barbiere di Siviglia"|14
tag|Teatro Real di Madrid|13
tag|Brescia, Teatro Grande|13
tag|Jan Latham-koening|13
tag|"Příhody lišky Bystroušky" (La piccola volpe astuta)|13
tag|Robert Carsen|13
tag|"Il barbiere di Siviglia"|13
tag|Modena|13
tag|Giandomenico Vaccari|13
tag|Roberto Gianola|12
tag|Jesi, Teatro Pergolesi|12
tag|"Nabucco"|12
tag|Nicola Paszkowski|12
tag|Jonathan Webb|12
tag|Andrea Cigni|12
tag|Fabio Sparvoli|12
tag|Teatro Petruzzelli di Bari|12
tag|Christopher Franklin|12
tag|"Die Zauberflöte" (Il Flauto Magico)|12
tag|Casciana Terme|12
tag|Antonio Pirolli|12
tag|Cagliari|12
tag|Giuseppe Finzi|12
tag|Roberto Andò|12
tag|Francesco Cilluffo|11
tag|Carlomoreno Volpini|11
tag|Francesco Lanzillotta|11
tag|Vittorio Sgarbi|11
tag|Giulio Ciabatti|11
tag|Emilio Sagi|11
tag|Busseto, Teatro Verdi|11
tag|Fabrizio Cassi|11
tag|Teatro Goldoni di Livorno|11
